Song,Actual,TF-IDF,TF-IDF Error,Custom,Custom Err
2 Become 1,1997,1997,0,1980,17
32 Flavors,1998,1998,0,2002,4
5 Miles To Empty,1997,1997,0,1980,17
A Little Past Little Rock,1998,1998,0,2002,4
A Rose Is Still A Rose,1998,1998,0,2006,8
A Song For Mama,1998,1998,0,1980,18
Adia,1998,1998,0,1996,2
All My Life,1998,1998,0,1980,18
All My Love,1998,1998,0,2012,14
All The Places (I Will Kiss You),1998,1998,0,2005,7
All This Time,1991,1991,0,1980,11
Am I Dreaming,1998,1998,0,1995,3
Are U Still Down,1998,1998,0,1997,1
Are You Jimmy Ray?,1998,1998,0,1980,18
Are You That Somebody?,1998,1998,0,1999,1
Ava Adore,1998,1998,0,1980,18
Been Around The World,1998,1998,0,1998,0
Been Around The World,1998,1998,0,1998,0
Been Around The World,1998,1998,0,1998,0
Big Pimpin',2000,2000,0,1996,4
Bizounce,2001,2001,0,2001,0
Black Ice (Sky High),1998,1998,0,2006,8
Black Or White,1991,1991,0,1980,11
Blunt Blowin,2011,2011,0,2006,5
Body Bumpin Yippie-Yi-Yo,1998,1998,0,1998,0
Body Bumpin' Yippie-Yi-Yo,1998,1998,0,1998,0
Body Language,2009,2009,0,2009,0
Boom Boom Pow,2009,2009,0,2009,0
Boom! Shake The Room,1993,1993,0,1993,0
Bop Gun (One Nation),1994,1994,0,1994,0
Bop Gun (One Nation),1994,1994,0,1994,0
Born This Way,2011,2011,0,2014,3
Born To Roll,1994,1994,0,1994,0
Bound 2,2013,2013,0,2004,9
Bow Down,1996,1996,0,1996,0
Break It Off,2007,2007,0,2007,0
Breathe,2004,2004,0,2004,0
Bring The Pain,1994,1994,0,1994,0
Bug A Boo,1999,1999,0,1999,0
Bugatti,2013,2013,0,2013,0
Buy U A Drank (Shawty Snappin'),2007,2007,0,2007,0
By The Way,2002,2002,0,2002,0
Bye Bye,1998,1998,0,1998,0
C'Mon,2013,2013,0,2013,0
Call Me,1997,1997,0,1997,0
Callin' Me,2000,2000,0,2000,0
Can I Have It Like That,2005,2005,0,2006,1
Can U Feel It,1997,1997,0,1980,17
Can't Be Friends,2010,2010,0,2010,0
Can't Deny It,2001,2001,0,2001,0
Can't Get Enough,1998,1998,0,1997,1
Can't Nobody Hold Me Down,1997,1997,0,1997,0
Can't Stop This Thing We Started,1991,1991,0,1980,11
Can't Stop Won't Stop,2003,2003,0,2003,0
Candle In The Wind 1997,1997,1997,0,2012,15
Cantaloop (Flip Fantasia),1994,1994,0,1994,0
Carlene,2000,2000,0,2000,0
Celebrity,2003,2003,0,2003,0
Cell Therapy,1995,1995,0,1995,0
Change Clothes,2003,2003,0,2003,0
Chante's Got A Man,1999,1999,0,1999,0
Check It Out,2010,2010,0,2010,0
Check It Out,2010,2010,0,2010,0
Cheers (Drink To That),2011,2011,0,2011,0
Cheers 2 U,1998,1998,0,1980,18
Chicken Noodle Soup,2006,2006,0,2006,0
Chinese Democracy,2008,2008,0,2008,0
Chinese Food,2013,2013,0,2003,10
Chopped 'N' Skrewed,2008,2008,0,2008,0
Clap Back,2003,2003,0,2003,0
Cleanin' Out My Closet,2002,2002,0,2002,0
Cleopatra's Theme,1998,1998,0,1998,0
Clock Strikes,1998,1998,0,1998,0
Clubbin,2003,2003,0,2003,0
Coco Jamboo,1997,1997,0,1997,0
Colors Of The Wind,1995,1995,0,1995,0
Colors Of The Wind,1995,1995,0,1995,0
Come And Get With Me,1998,1998,0,1998,0
Could It Be,2001,2001,0,2000,1
Crack A Bottle,2009,2009,0,2009,0
Crank That (Soulja Boy),2007,2007,0,2007,0
Cruel Summer,1998,1998,0,1980,18
Culo,2004,2004,0,2004,0
Cumbersome,1996,1996,0,1996,0
Cut Her Off,2014,2014,0,2002,12
D.O.A. (Death Of Auto-Tune),2009,2009,0,2009,0
Damn!,2003,2003,0,2003,0
Danger,1995,1995,0,1995,0
Dangerous,1998,1998,0,1998,0
Daydreamin',1998,1998,0,1998,0
Deeper Shade Of Soul,1991,1991,0,1991,0
Deja Vu (Uptown Baby),1998,1998,0,1998,0
Deja Vu (Uptown Baby),1998,1998,0,1998,0
Destiny,1998,1998,0,2013,15
Did You Ever Think,1999,1999,0,1999,0
Die Another Day,2002,2002,0,2002,0
Dirt Off Your Shoulder,2004,2004,0,2004,0
Discotheque,1997,1997,0,2011,14
Ditty,1993,1993,0,1993,0
Do For Love,1998,1998,0,1998,0
Do It Just Like A Rockstar,2007,2007,0,2007,0
Do You Know (What It Takes),1997,1997,0,1980,17
Do You Like This,1997,1997,0,1980,17
Do You Wanna Get Funky,1994,1994,0,1994,0
Do Your Thing,1998,1998,0,1980,18
Don't Cha,2005,2005,0,2005,0
Don't Cry,1996,1996,0,1996,0
Don't Drop That Thun Thun!,2013,2013,0,2013,0
Don't Lie,2005,2005,0,2005,0
Don't Mess With My Man,2002,2002,0,2002,0
Don't Wanna Be A Player,1997,1997,0,1997,0
Don't Wanna Try,2003,2003,0,2003,0
Doo Wop (That Thing),1998,1998,0,1998,0
Down 4 U,2002,2002,0,2002,0
Downtown,2015,2015,0,2015,0
Downtown Train,1990,1990,0,1980,10
Drive,1992,1992,0,1992,0
Drop It Like It's Hot,2004,2004,0,2004,0
Drop It Low,2009,2009,0,2009,0
Drops Of Jupiter (Tell Me),2001,2001,0,2001,0
Drunk In Love,2014,2014,0,2014,0
Drunk In Love,2014,2014,0,2014,0
E-Bow The Letter,1996,1996,0,2007,11
E.T.,2010,2010,0,2010,0
ESPN Presents The Jock Jam,1997,1997,0,1997,0
EW!,2014,2014,0,2014,0
Elevator,2008,2008,0,2008,0
Elevators (Me & You),1996,1996,0,1996,0
Energy,2015,2015,0,2015,0
Errtime,2005,2005,0,2005,0
Every Girl,2009,2009,0,2009,0
Everybody's Free (To Wear Sunscreen),1999,1999,0,1999,0
Everyday Is A Winding Road,1997,1997,0,1997,0
Everything,1997,1997,0,1989,8
Everything Is Everything,1999,1999,0,1999,0
Everything's Gonna Be Alright,1998,1998,0,1998,0
Excuse Me Miss,2003,2003,0,2003,0
Faded,2012,2012,0,2012,0
Faded Pictures,1999,1999,0,1999,0
Falling In Love (Is Hard On The Knees),1997,1997,0,1997,0
Fantastic Voyage,1994,1994,0,1994,0
Fast Lane,2011,2011,0,2011,0
Father,1998,1998,0,1998,0
Feel Good Inc,2005,2005,0,2005,0
Feel Me Flow,1995,1995,0,1995,0
Feeling Myself,2015,2015,0,2015,0
Fiesta,2001,2001,0,2001,0
Firestarter,1997,1997,0,1997,0
Flava In Ya Ear,1994,1994,0,1994,0
Flowers On The Wall,2000,2000,0,2009,9
Fly,2011,2011,0,2011,0
Foe Tha Love Of $,1995,1995,0,1995,0
For You I Will,1999,1999,0,2001,2
For You I Will,1997,1997,0,1980,17
Forever,2009,2009,0,2009,0
Forever And For Always,2003,2003,0,2003,0
Forgot About Dre,2000,2000,0,2000,0
Freakit,1993,1993,0,1993,0
Freedom,1995,1995,0,1995,0
Freek-A-Leek,2004,2004,0,2004,0
Fresh Azimiz,2006,2006,0,2006,0
Friday,2011,2011,0,2009,2
Friend Of Mine,1998,1998,0,1980,18
From This Moment On,1998,1998,0,1980,18
Frontin',2003,2003,0,2003,0
Frozen,1998,1998,0,1998,0
Fu-Gee-La,1996,1996,0,1996,0
Funky Y-2-C,1994,1994,0,1994,0
G'D Up,2000,2000,0,2000,0
G.D.F.R.,2015,2015,0,2015,0
Gangnam Style,2012,2012,0,2012,0
Gangnam Style,2012,2012,0,2012,0
Gangsta Lean,1993,1993,0,1993,0
Gangsta Lovin',2002,2002,0,2002,0
Gangsta Nation,2004,2004,0,2004,0
Gangstas Make The World Go Round,1997,1997,0,1997,0
Gas Pedal,2013,2013,0,2013,0
Gasolina,2005,2005,0,2005,0
Gentleman,2013,2013,0,2013,0
Get At Me Dog,1998,1998,0,1998,0
Get Buck In Here,2007,2007,0,2007,0
Get Busy,2003,2003,0,2003,0
Get Down,1995,1995,0,1995,0
Get Here,1991,1991,0,1991,0
Get It Poppin',2005,2005,0,2005,0
Get Low,2003,2003,0,2003,0
Get Silly,2008,2008,0,2008,0
Get Ur Freak On,2001,2001,0,2001,0
Gettin' Jiggy Wit It,1998,1998,0,1998,0
Getto Man,1993,1993,0,1993,0
Ghetto Cowboy,1998,1998,0,1998,0
Ghetto Love,1997,1997,0,1997,0
Ghetto Supastar (That Is What You Are),1998,1998,0,1998,0
Ghetto Supastar (That Is What You Are),1998,1998,0,1998,0
Ghetto Supastar (That Is What You Are),1998,1998,0,1998,0
Ghetto Supastar (That Is What You Are),1998,1998,0,1998,0
Ghetto Supastar (That Is What You Are),1998,1998,0,1998,0
Gimme Some Love,1997,1997,0,1997,0
Gimme The Light,2002,2002,0,2002,0
Girlfriend,2003,2003,0,2003,0
Girls Girls Girls,2001,2001,0,2001,0
Gitty Up,1998,1998,0,2001,3
Give It To Me,2007,2007,0,2007,0
Give Me Just One Night (Una Noche),2000,2000,0,2000,0
Given To Fly,1998,1998,0,1998,0
Glaciers Of Ice/Criminology,1995,1995,0,1995,0
Glaciers Of Ice/Criminology,1995,1995,0,1995,0
Go D.J.,2004,2004,0,2004,0
Gold Digger,2005,2005,0,2005,0
Gone,2013,2013,0,2012,1
Gone Till November,1998,1998,0,1998,0
Gonorrhea,2010,2010,0,2008,2
Good Morning,2009,2009,0,2009,0
Good Stuff,1992,1992,0,1992,0
Good Times,2002,2002,0,2002,0
Goodbye,1998,1998,0,1980,18
Goodbye Earl,2000,2000,0,2000,0
Goodbye To My Homies,1998,1998,0,1998,0
Goodbye To My Homies,1998,1998,0,1998,0
Goodies,2004,2004,0,2004,0
Gossip Folks,2003,2003,0,1981,22
Got To Get,1990,1990,0,1990,0
Got To Get it,1999,1999,0,2010,11
Got Your Money,1999,1999,0,1999,0
Gotham City,1997,1997,0,1997,0
Gotta Be,1998,1998,0,1980,18
Gotta Man,1999,1999,0,1999,0
Grindin',2002,2002,0,2002,0
Guts Over Fear,2014,2014,0,1995,19
H*A*M,2011,2011,0,2011,0
Handlebars,2008,2008,0,2008,0
Hands Clean,2002,2002,0,2002,0
Hangover,2014,2014,0,2003,11
Happily Ever After,1999,1999,0,1999,0
Harlem Shake,2013,2013,0,2013,0
Having A Party,1994,1994,0,1994,0
Hay,1996,1996,0,1996,0
He Loves U Not,2000,2000,0,2000,0
Head Over Heels,1997,1997,0,1997,0
Heartbreaker,1999,1999,0,1999,0
Heaven,1998,1998,0,1980,18
Heaven's What I Feel,1998,1998,0,1990,8
Hell Breaks Loose,2010,2010,0,2002,8
Hell Yeah,2003,2003,0,2003,0
Hello Good Morning,2010,2010,0,2010,0
Hello Goodbye,2010,2010,0,1980,30
Here,2015,2015,0,2015,0
Here (In Your Arms),2007,2007,0,2007,0
Here I Am,2008,2008,0,2008,0
Here's To Never Growing Up,2013,2013,0,2013,0
Here's Your Sign (Get The Picture),1997,1997,0,1997,0
Hey Leonardo (She Likes Me For Me),1999,1999,0,1999,0
Hey Lover,1995,1995,0,1995,0
Hey Ma,2002,2002,0,2002,0
Hey Mama,2004,2004,0,2004,0
Hey Now Now,1998,1998,0,1980,18
Hey Ya!,2003,2003,0,2003,0
Hillbilly Bone,2010,2010,0,2010,0
Hip Hop Hooray,1993,1993,0,1993,0
Hoedown Throwdown,2009,2009,0,2009,0
Holidae In,2003,2003,0,2003,0
Holiday,2005,2005,0,2005,0
Holla Holla,1999,1999,0,1999,0
Home,2012,2012,0,2012,0
Home To You,1999,1999,0,1999,0
Hood Figga,2007,2007,0,2007,0
Horse & Carriage,1998,1998,0,1998,0
Horse & Carriage,1998,1998,0,1998,0
Hot Boy,2014,2014,0,2014,0
Hot Tottie,2010,2010,0,2010,0
Housecall,1991,1991,0,1991,0
How 'Bout Them Cowgirls,2007,2007,0,2005,2
How Deep Is Your Love,1998,1998,0,1998,0
How Deep is Your Love,1998,1998,0,1998,0
How High,1995,1995,0,1995,0
Hush,2004,2004,0,2004,0
Hypnotize,1997,1997,0,1997,0
I Adore Mi Amor,1991,1991,0,1991,0
I Believe In You And Me,1997,1997,0,1980,17
I Can,2003,2003,0,2003,0
I Can Do That,1998,1998,0,2004,6
I Can Love You,1997,1997,0,1997,0
I Can't Wait,2004,2004,0,2004,0
I Do!!,2001,2001,0,2001,0
I Don't Ever want To See You Again,1997,1997,0,1997,0
I Don't Want To Miss A Thing,1998,1998,0,1980,18
I Don't Want To Wait,1998,1998,0,1997,1
I Get Lonely,1998,1998,0,1998,0
I Get Lonely,1998,1998,0,1998,0
I Get Money,2007,2007,0,2007,0
I Got 5 On It,1995,1995,0,1995,0
I Got A Man,1993,1993,0,1993,0
I Got It From My Mama,2007,2007,0,2007,0
I Got The Hook Up!,1998,1998,0,1998,0
I Got The Hook Up!,1998,1998,0,1998,0
I Gotta Feeling,2009,2009,0,2009,0
I Had No Right,1998,1998,0,1982,16
I Just Wanna Love U (Give It 2 Me),2000,2000,0,2000,0
I Know Where It's At,1998,1998,0,2012,14
I Know You Want Me (Calle Ocho),2009,2009,0,2009,0
I Like It,2000,2000,0,2000,0
I Like It,1997,1997,0,1997,0
I Like That,2004,2004,0,2004,0
I Love This Bar,2003,2003,0,2003,0
I Love You,1999,1999,0,1999,0
I Love You Always Forever,1996,1996,0,1996,0
I Made It (Cash Money Heroes),2010,2010,0,2010,0
I Miss My Homies,1997,1997,0,1997,0
I Miss My Homies,1997,1997,0,1997,0
I Shot The Sheriff,1997,1997,0,1997,0
I Still Love You,1998,1998,0,1980,18
I Think They Like Me,2005,2005,0,2005,0
I Wanna Be There,1997,1997,0,1980,17
I Wanna Go,2011,2011,0,2011,0
I Wanna Love You,2006,2006,0,2006,0
I Wanna Rock,2010,2010,0,2010,0
I Wanna Talk About Me,2001,2001,0,2001,0
I Want It All,1999,1999,0,1999,0
I Want You,1997,1997,0,1997,0
I Want You,2003,2003,0,2003,0
I Want You Back,1998,1998,0,1980,18
I Will?But,2000,2000,0,2000,0
I Wish,1995,1995,0,1995,0
I Write Sins Not Tragedies,2006,2006,0,2006,0
I'll Be,1998,1998,0,1998,0
I'll Be,1997,1997,0,1997,0
I'll Never Break Your Heart,1998,1998,0,1980,18
I'll Think Of A Reason Later,1999,1999,0,1999,0
I'm A Thug,2001,2001,0,2001,0
I'm Already Taken,1999,1999,0,1999,0
I'm Alright,1998,1998,0,2008,10
I'm Awesome,2010,2010,0,2010,0
I'm Going In,2009,2009,0,2009,0
I'm Gonna Be (500 Miles),1993,1993,0,1993,0
I'm Gonna Get You,1993,1993,0,1993,0
I'm Gonna Get You,1993,1993,0,1993,0
I'm Out,2013,2013,0,2013,0
I'm Still A Guy,2008,2008,0,2008,0
I'm Your Angel,1998,1998,0,1980,18
Ice Cream,1995,1995,0,1995,0
Ice Cream Paint Job,2009,2009,0,2009,0
Iesha,1991,1991,0,1991,0
If I Could Teach The World,1997,1997,0,1997,0
If You (Lovin' Me),1999,1999,0,1999,0
If You Think I'm Jiggy,1998,1998,0,1998,0
Imagination,1998,1998,0,1998,0
In A Real Love,2004,2004,0,2004,0
In My Head,2010,2010,0,2010,0
In My Life,2004,2004,0,2004,0
In The House Of Stone And Light,1995,1995,0,1995,0
Independent Women,2000,2000,0,2000,0
Indian Outlaw,1994,1994,0,1994,0
Insane In The Brain,1993,1993,0,1993,0
Inside Out,1998,1998,0,1998,0
Intergalactic,1998,1998,0,1998,0
Iris,1998,1998,0,1980,18
It Ain't My Fault 1 & 2,1999,1999,0,1999,0
It Must Be Love,1998,1998,0,2002,4
It Won't Stop,2013,2013,0,2013,0
It's All About Me,1998,1998,0,1998,0
It's All About Me,1998,1998,0,1998,0
It's All Been Done,1999,1999,0,1999,0
It's Not Right But It's Okay,1999,1999,0,1999,0
Izzo (H.O.V.A.),2001,2001,0,2001,0
Jai Ho! (You Are My Destiny),2009,2009,0,2009,0
Jamboree,1999,1999,0,1999,0
Jealousy,1996,1996,0,1996,0
Jesus Walks,2004,2004,0,2004,0
Jigga My N****,1999,1999,0,1999,0
John Cougar John Deere John 3:16,2015,2015,0,2015,0
Judas,2011,2011,0,2011,0
Jumpman,2015,2015,0,2015,0
Just A Girl,1996,1996,0,1996,0
Just Another Day,1997,1997,0,2003,6
Just Between You And Me,1996,1996,0,1996,0
Just Can't Get Enough,2011,2011,0,2011,0
Just Can't Get Enough,2011,2011,0,2011,0
Just Lose It,2004,2004,0,2004,0
Just Stand Up!,2008,2008,0,2011,3
Just The Two Of Us,1998,1998,0,1998,0
Keep Their Heads Ringin',1995,1995,0,1995,0
Key West Intermezzo (I Saw You First),1996,1996,0,1996,0
Kick The Dust Up,2015,2015,0,2015,0
Killa,2008,2008,0,2008,0
King Without A Crown,2006,2006,0,2006,0
Kiss Kiss,2007,2007,0,2007,0
Kiss The Rain,1998,1998,0,1980,18
Kiss Them For Me,1991,1991,0,1991,0
Kiss This,2000,2000,0,2000,0
Kiss You,2013,2013,0,2013,0
Knockin' Boots,1990,1990,0,1990,0
Know Your Enemy,2009,2009,0,2009,0
Krazy,2008,2008,0,2008,0
Kryptonite (I'm On It),2005,2005,0,2005,0
Kyrptonite (I'm On It),2006,2006,0,2005,1
L.A.LOVE (la la),2014,2014,0,2014,0
La Raza,1990,1990,0,1990,0
La Tortura,2005,2005,0,2005,0
Lady Marmalade,2001,2001,0,2001,0
Lambada,1990,1990,0,1990,0
Larger Than Life,1999,1999,0,1999,0
Last Kiss,1999,1999,0,1991,8
Last Night,1996,1996,0,1996,0
Latch,2014,2014,0,2014,0
Lately,1998,1998,0,1998,0
Lay Low,2001,2001,0,1995,6
Lean Back,2004,2004,0,2004,0
Lean Like A Cholo,2007,2007,0,2007,0
Lean Wit It Rock Wit It,2006,2006,0,2006,0
Legend Of A Cowgirl,1997,1997,0,1997,0
Lemme See,2012,2012,0,2012,0
Let It Go,2014,2014,0,2014,0
Let It Go,1997,1997,0,1997,0
Let Me Blow Ya Mind,2001,2001,0,2001,0
Let Me Clear My Throat,1997,1997,0,1997,0
Let Me In,2004,2004,0,2004,0
Let Me Ride,1993,1993,0,1993,0
Let's Get Away,2004,2004,0,2004,0
Let's Get Down,2003,2003,0,2003,0
Let's Get It Started,2004,2004,0,2004,0
Let's Play House,1996,1996,0,1996,0
Let's Ride,1998,1998,0,1998,0
Let's Ride,1998,1998,0,1998,0
Let's Ride,2006,2006,0,2005,1
Liar,2000,2000,0,2000,0
Lifestyle,2014,2014,0,2014,0
Light In Your Eyes,1998,1998,0,1992,6
Light Up The World,2011,2011,0,2010,1
Lighters,2011,2011,0,2011,0
Lighters Up,2005,2005,0,2005,0
Like A G6,2010,2010,0,2010,0
Like A Pimp,2003,2003,0,2003,0
Like Glue,2003,2003,0,2003,0
Lil Freak,2010,2010,0,2010,0
Lips Are Movin',2014,2014,0,2014,0
Liquid Swords,1995,1995,0,1995,0
Little Good-Byes,1999,1999,0,1999,0
Little Man,1999,1999,0,1999,0
Livin' It Up,2001,2001,0,2001,0
Loca,2010,2010,0,2014,4
Lollipop,2008,2008,0,2008,0
Long Time Gone,2002,2002,0,2002,0
Lookin Boy,2008,2008,0,2006,2
Lookin' At Me,1998,1998,0,1997,1
Looking Through Patient Eyes,1993,1993,0,1993,0
Looking Through Your Eyes,1998,1998,0,1980,18
Lose Control,2005,2005,0,2005,0
Lose My Mind,2010,2010,0,2010,0
Lose Yourself,2002,2002,0,2002,0
Loser,1994,1994,0,1994,0
Lost In You,1999,1999,0,1999,0
Lost Without U,2007,2007,0,2007,0
Love At 1st Sight,2003,2003,0,2003,0
Love Gets Me Every Time,1997,1997,0,1997,0
Love Like Crazy,2010,2010,0,2010,0
Love Like This,1998,1998,0,1980,18
Love Me,1998,1998,0,1998,0
Love Me,2013,2013,0,2013,0
Love Me Or Hate Me (F**k You!!!!),2006,2006,0,2004,2
Love You Down,1998,1998,0,1980,18
Love You Down,1998,1998,0,1980,18
Love You Down,1998,1998,0,1980,18
Lucas With The Lid Off,1994,1994,0,1994,0
Luchini aka (This Is It),1997,1997,0,1997,0
Luxurious,2005,2005,0,2005,0
Magic,2010,2010,0,2010,0
Make 'Em Say Uhh!,1998,1998,0,1998,0
Make 'Em Say Uhh!,1998,1998,0,1998,0
Make 'Em Say Uhh!,1998,1998,0,1998,0
Make 'Em Say Uhh!,1998,1998,0,1998,0
Make Her Say,2009,2009,0,2009,0
Make It Clap,2003,2003,0,2003,0
Make Me Proud,2011,2011,0,2011,0
Mama Said Knock You Out,1991,1991,0,1991,0
Man On The Moon,1993,1993,0,1993,0
Man! I Feel Like A Woman!,1999,1999,0,1999,0
Maria Maria,2000,2000,0,2000,0
Marvin Gaye,2015,2015,0,2015,0
Me Against The Music,2003,2003,0,2003,0
Me And My Gang,2006,2006,0,2010,4
Meanwhile,1999,1999,0,1999,0
Mentirosa,1990,1990,0,1990,0
Mercy,2012,2012,0,2012,0
Mercy,2012,2012,0,2012,0
Mesmerize,2003,2003,0,2003,0
Mishale,1995,1995,0,1995,0
Miss Independent,2003,2003,0,2003,0
Miss Me,2010,2010,0,2010,0
Mmm Yeah,2014,2014,0,2014,0
Mmmbop,1997,1997,0,1997,0
Mo Money Mo Problems,1997,1997,0,1997,0
Mo Money Mo Problems,1997,1997,0,1997,0
Moment 4 Life,2011,2011,0,2011,0
Moment 4 Life,2011,2011,0,2011,0
Money Power & Respect,1998,1998,0,1998,0
Money Power & Respect,1998,1998,0,1998,0
Monster,2010,2010,0,2010,0
More Than A Woman,2002,2002,0,2002,0
Most Girls,2000,2000,0,2000,0
Move B***h,2002,2002,0,2002,0
Move That Doh,2014,2014,0,2014,0
Mr. Loverman,1992,1992,0,1992,0
Mr. Mom,2004,2004,0,2004,0
Mr. Personality,1995,1995,0,1995,0
Mr. Saxobeat,2011,2011,0,2011,0
Mr. Wendal,1993,1993,0,1993,0
Ms. New Booty,2006,2006,0,2006,0
My All,1998,1998,0,1998,0
My Baby,2001,2001,0,2001,0
My Baby Daddy,1997,1997,0,1997,0
My Band,2004,2004,0,2004,0
My Chick Bad,2010,2010,0,2010,0
My Favorite Girl,1999,1999,0,2014,15
My Favorite Mistake,1998,1998,0,1980,18
My Heart Is Failing Me,1991,1991,0,1991,0
My Heart Will Go On,1998,1998,0,1980,18
My Humps,2005,2005,0,2005,0
My Little Secret,1998,1998,0,2005,7
My Name Is,1999,1999,0,1999,0
My Name Is Prince,1992,1992,0,1992,0
My Side Of The Bed,1991,1991,0,1991,0
My Way,1998,1998,0,1997,1
Naked Eye,1997,1997,0,1997,0
Nappy Heads,1994,1994,0,1994,0
Need U Bad,2008,2008,0,2008,0
Neighbors Know My Name,2010,2010,0,2010,0
Never Ever,1998,1998,0,1998,0
Never Gonna Let You Go,1999,1999,0,1980,19
Never Scared,2003,2003,0,2003,0
Nice,1998,1998,0,1998,0
Nice & Slow,1998,1998,0,1998,0
No Better Love,2004,2004,0,2004,0
No Diggity,1996,1996,0,1996,0
No Flex Zone,2014,2014,0,2014,0
No Hands,2010,2010,0,2010,0
No Love,2010,2010,0,2010,0
"No More ""I Love You's""",1995,1995,0,1995,0
No More Lies,1990,1990,0,1990,0
No Myth,1990,1990,0,1990,0
No New Friends,2013,2013,0,2013,0
No Pigeons,1999,1999,0,1999,0
No Tengo Dinero,1997,1997,0,1997,0
Nobody Does It Better,1998,1998,0,1998,0
Nobody Else,1998,1998,0,1993,5
Nolia Clap,2004,2004,0,2004,0
Not Tonight,1997,1997,0,1997,0
Not Tonight,1997,1997,0,1997,0
Nothin',2002,2002,0,2002,0
Now That We Found Love,1991,1991,0,1991,0
Number One Spot,2005,2005,0,2005,0
Nuthin' But A 'G' Thang,1993,1993,0,1993,0
OMG,2010,2010,0,2010,0
Obsession (No Es Amor),2005,2005,0,2005,0
Odio,2014,2014,0,2005,9
Oh,2005,2005,0,2005,0
Oh Boy,2002,2002,0,2002,0
Oh Yeah!,2002,2002,0,2000,2
Okay,2005,2005,0,2005,0
Old Time's Sake,2009,2009,0,2004,5
On & On,1997,1997,0,1997,0
On A Sunday Afternoon,1992,1992,0,1992,0
One Less Lonely Girl,2009,2009,0,2009,0
One Love (People Get Ready),2010,2010,0,2010,0
One Mic,2002,2002,0,2002,0
One Minute Man,2001,2001,0,2001,0
One More Chance/Stay With Me,1995,1995,0,1995,0
One Sweet Day,1995,1995,0,1995,0
One Way Or Another (Teenage Kicks),2013,2013,0,2013,0
One Week,1998,1998,0,1998,0
One Woman Man,2001,2001,0,2001,0
Online,2007,2007,0,2007,0
Only,2014,2014,0,2014,0
Oochie Coochie,1992,1992,0,1992,0
Oochie Wally,2001,2001,0,2001,0
Ooh La La,1998,1998,0,1998,0
Oops (Oh My),2002,2002,0,2002,0
Otis,2011,2011,0,2011,0
Otis,2011,2011,0,2011,0
Out Here Grindin',2008,2008,0,2008,0
Overnight Celebrity,2004,2004,0,2004,0
Oye Mi Canto,2004,2004,0,2004,0
Oye Mi Canto (Hear My Voice),1990,1990,0,1990,0
P.I.M.P.,2003,2003,0,2003,0
Paper,1998,1998,0,1980,18
Paper Doll,1992,1992,0,1992,0
Paradise,2011,2011,0,2011,0
Paradise,2003,2003,0,2003,0
Paranoid,2014,2014,0,2014,0
Partition,2014,2014,0,2014,0
Party,2011,2011,0,1990,21
Party People,2008,2008,0,2008,0
Party Rock Anthem,2011,2011,0,2011,0
Party Rock Anthem,2011,2011,0,2011,0
Party Up (Up In Here),2000,2000,0,2000,0
Pass That Dutch,2003,2003,0,2003,0
Pass The Courvoisier Part II,2002,2002,0,2002,0
Peaches,1996,1996,0,1996,0
Peaches & Cream,2001,2001,0,2001,0
Penomenal,2015,2015,0,2013,2
People Are Still Having Sex,1991,1991,0,1991,0
Pimpin' All Over The World,2005,2005,0,2005,0
Play Something Country,2005,2005,0,2009,4
Playaz Club,1994,1994,0,1994,0
Player's Anthem,1995,1995,0,1995,0
Player's Ball,1994,1994,0,1994,0
Player's Ball,1994,1994,0,1994,0
Players Anthem,1995,1995,0,1995,0
Please Don't Go,1992,1992,0,1992,0
Po Pimp,1996,1996,0,1996,0
Po' Folks,2002,2002,0,2002,0
Poker Face,2010,2010,0,2009,1
Poker Face,2009,2009,0,2009,0
Pop Goes The Weasel,1991,1991,0,1991,0
Pop That,2012,2012,0,2012,0
Pound The Alarm,2012,2012,0,2012,0
Power,2010,2010,0,2010,0
Power,2010,2010,0,2010,0
Power Windows,1991,1991,0,1991,0
Prayin' For Daylight,2000,2000,0,2000,0
Pretty Wings,2009,2009,0,2009,0
Princess Of China,2011,2011,0,2010,1
Project Chick,2001,2001,0,2001,0
Pump It,2006,2006,0,2006,0
Pump It Up,2003,2003,0,2003,0
Pumps And A Bump,1994,1994,0,1994,0
Purple Hills,2001,2001,0,2001,0
Put On,2008,2008,0,2008,0
R.I.C.O.,2015,2015,0,2015,0
Rack City,2012,2012,0,2012,0
Rain,1998,1998,0,1998,0
Rain Over Me,2011,2011,0,2011,0
Raise The Roof,1998,1998,0,1998,0
Raise Up,2001,2001,0,2001,0
Rap God,2013,2013,0,2013,0
Rather Be,2014,2014,0,2014,0
Ray Of Light,1998,1998,0,1998,0
React,2002,2002,0,2002,0
Ready To Run,1999,1999,0,1980,19
Real World,1998,1998,0,1998,0
Rebirth Of Slick (Cool Like Dat),1993,1993,0,1993,0
Redneck Yacht Club,2005,2005,0,2005,0
Renegades,2015,2015,0,2015,0
Replay,2014,2014,0,2014,0
Request Line,1997,1997,0,1997,0
Rewind,2014,2014,0,2014,0
Rhythm Divine,2000,2000,0,2000,0
Rich As F**k,2013,2013,0,2013,0
Rico Suave,1991,1991,0,1991,0
Ride Wit Me,2001,2001,0,2001,0
Ridin',2006,2006,0,2006,0
Right Thurr,2003,2003,0,2003,0
Right Where I Need To Be,2001,2001,0,2001,0
Rock Yo Hips,2007,2007,0,2007,0
Rocketeer,2011,2011,0,2011,0
Rockin' Around The Christmas Tree,2014,2014,0,1980,34
Rockstar,2007,2007,0,2007,0
Roll Up,2011,2011,0,2011,0
Romeo And Juliet,1998,1998,0,1998,0
Romeo And Juliet,1998,1998,0,1998,0
Romeo And Juliet,1998,1998,0,1998,0
Rompe,2006,2006,0,2006,0
Rub You The Right Way,1990,1990,0,1990,0
Rubber Band Man,2004,2004,0,2004,0
Ruffneck,1993,1993,0,1993,0
Run-Around,1995,1995,0,1995,0
Runaway,1995,1995,0,1995,0
Runaway,2010,2010,0,2010,0
Same Love,2013,2013,0,2013,0
Satisfy You,1999,1999,0,1999,0
Saturday (Oooh! Ooooh!),2002,2002,0,2002,0
Say It,1998,1998,0,2013,15
Scar Tissue,1999,1999,0,1999,0
Second Round K.O.,1998,1998,0,1998,0
Secret Garden,1997,1997,0,1997,0
Semi-Charmed Life,1997,1997,0,1997,0
Sexy Lady,2007,2007,0,2007,0
Sgt. Pepper's Lonely Hearts Club Band,2005,2005,0,1980,25
Shake,2005,2005,0,2005,0
Shake That,2006,2006,0,2006,0
Shake Ya Ass,2000,2000,0,2000,0
Shawty Get Loose,2008,2008,0,2008,0
Shawty Is A 10,2007,2007,0,2007,0
She Wolf,2009,2009,0,2009,0
She's So High,1999,1999,0,1999,0
She's So Mean,2012,2012,0,2012,0
Shimmer,1998,1998,0,1998,0
Short Dick Man,1994,1994,0,1994,0
Shorty (You Keep Playin With My Mind),1998,1998,0,1998,0
Shorty (You Keep Playin' With My Mind),1998,1998,0,1998,0
Show Stopper,2006,2006,0,2006,0
Shut It Down,2010,2010,0,2010,0
Shut Up And Drive,2007,2007,0,2007,0
Shy Guy,1995,1995,0,1995,0
Sick Of Being Lonely,2003,2003,0,2003,0
Sing For The Moment,2003,2003,0,2003,0
Single White Female,1999,1999,0,1999,0
Sittin' On Top Of The World,1996,1996,0,1996,0
Slam,1993,1993,0,1993,0
Sleazy Remix 2.0 Get Sleazie?,2011,2011,0,2009,2
Slide,1999,1999,0,1984,15
Slow Motion,2004,2004,0,2004,0
Smack That,2006,2006,0,2006,0
Smells Like Nirvana,1992,1992,0,1992,0
Smile,1997,1997,0,1997,0
Smokin' Me Out,1997,1997,0,1997,0
Snake,2003,2003,0,2003,0
So Anxious,1999,1999,0,1999,0
So Fine,2009,2009,0,1994,15
So Fresh So Clean,2001,2001,0,2001,0
So Good,2012,2012,0,2012,0
So Into You,1998,1998,0,1980,18
So Sexy,2004,2004,0,2004,0
Sock It 2 Me,1997,1997,0,1997,0
Solitaire,2004,2004,0,2004,0
Some Beach,2004,2004,0,2004,0
Someday,1996,1996,0,1996,0
Someone,1997,1997,0,1997,0
Someone You Used To Know,1998,1998,0,1980,18
Somethin' 4 Da Honeyz,1995,1995,0,1995,0
Sometimes I Rhyme Slow,1992,1992,0,1992,0
Sorry For Party Rocking,2012,2012,0,2011,1
Soul To Squeeze,1993,1993,0,1993,0
South Side,2001,2001,0,2001,0
Southern Hospitality,2001,2001,0,2001,0
Southern Voice,2009,2009,0,2009,0
Southside,2004,2004,0,2004,0
Space Jam,1997,1997,0,1997,0
Space Jam,1997,1997,0,1997,0
Spackavellie,1998,1998,0,1998,0
Spark,1998,1998,0,2001,3
Spice Up Your Life,1997,1997,0,1997,0
Spirit Of A Boy Wisdom Of A Man,1999,1999,0,1999,0
Splackavellie,1998,1998,0,1998,0
Spotlight,2009,2009,0,2009,0
Sprinkle Me,1995,1995,0,1995,0
Sprinkle Me,1995,1995,0,1995,0
Stacy's Mom,2003,2003,0,2003,0
Stanky Legg,2009,2009,0,2005,4
Starry Eyed Surprise,2002,2002,0,2002,0
Starships,2012,2012,0,2012,0
Start Of Something New,2006,2006,0,2007,1
Stay Fly,2005,2005,0,2005,0
Steady Mobbin',2010,2010,0,2010,0
Steal My Sunshine,1999,1999,0,1999,0
Steam,1993,1993,0,1993,0
Stick To The Status Quo,2006,2006,0,1994,12
Still A G Thang,1998,1998,0,1998,0
Still Fly,2002,2002,0,2002,0
Still Not A Player,1998,1998,0,1998,0
Stole,2002,2002,0,2002,0
Stoner,2014,2014,0,2014,0
Stop,1998,1998,0,1980,18
Straight To The Bank,2007,2007,0,2005,2
Strange Clouds,2011,2011,0,2011,0
Strawberries,1998,1998,0,2008,10
Stronger,2007,2007,0,2007,0
Stunt 101,2003,2003,0,2003,0
Suds In The Bucket,2004,2004,0,2004,0
Suga Suga,2003,2003,0,2003,0
Sugar Hill,1995,1995,0,1995,0
Suit & Tie,2013,2013,0,2013,0
Summer Girls,1999,1999,0,1999,0
Summertime,2006,2006,0,2006,0
Super Bass,2011,2011,0,2011,0
SuperThug (What What),1998,1998,0,1998,0
Supermodel (You Better Work),1993,1993,0,1993,0
Superstar,2008,2008,0,2008,0
Survival,2013,2013,0,2013,0
Swagga Like Us,2008,2008,0,2008,0
Swagga Like Us,2008,2008,0,2008,0
Sweet Southern Comfort,2004,2004,0,2004,0
Sweet Surrender,1998,1998,0,1998,0
Swing My Way,1998,1998,0,1998,0
Swing My Way,1998,1998,0,1998,0
T.H.E. (The Hardest Ever),2011,2011,0,2007,4
Take Away,2002,2002,0,2002,0
Take It To Da House,2001,2001,0,2003,2
Take Me To Church,2014,2014,0,2014,0
Tambourine,2007,2007,0,2002,5
Tapout,2013,2013,0,2013,0
Tapout,2013,2013,0,2013,0
Tattoos On This Town,2011,2011,0,2011,0
Teach Me How To Dougie,2010,2010,0,2010,0
Tell Me (What's Goin' On),2003,2003,0,2003,0
Tell Me Baby,2006,2006,0,2008,2
Tell Me When,1995,1995,0,1995,0
Tell Me When To Go,2006,2006,0,2006,0
Temperature,2006,2006,0,2006,0
Tennessee,1992,1992,0,1992,0
Tequila,1992,1992,0,1997,5
Tequila Makes Her Clothes Fall Off,2005,2005,0,2005,0
Thank U,1998,1998,0,1998,0
That Girl,2006,2006,0,2006,0
That Girl,1996,1996,0,1996,0
That Way,2011,2011,0,2015,4
That's All She Wrote,2010,2010,0,2010,0
That's Not My Name,2009,2009,0,2009,0
The Adventures Of Rain Dance Maggie,2011,2011,0,1995,16
The Anthem,2008,2008,0,2008,0
The Arms Of The One Who Loves You,1998,1998,0,1980,18
The Best Day,2000,2000,0,1992,8
The Best Things In Life Are Free,1992,1992,0,1992,0
The Blower's Daughter,2014,2014,0,2013,1
The Bomb! (These Sounds Fall Into My Mind),1995,1995,0,1995,0
The Boss,2008,2008,0,2008,0
The Boy Is Mine,1998,1998,0,1998,0
The Catalyst,2010,2010,0,1993,17
The Cup Of Life,1999,1999,0,1999,0
The Devil Came Up To Michigan,1991,1991,0,1991,0
The Fighter,2012,2012,0,2012,0
The First Night,1998,1998,0,1980,18
The Fox,2013,2013,0,2013,0
The Freshmen,1997,1997,0,1997,0
The Hills,2015,2015,0,2015,0
The Humpty Dance,1990,1990,0,1990,0
The Itch,2000,2000,0,2000,0
The Jump Off,2003,2003,0,2003,0
The Lazy Song,2011,2011,0,2011,0
The Light,2000,2000,0,2000,0
The Memory Remains,1997,1997,0,1997,0
The Monster,2013,2013,0,2013,0
The Most Beautifullest Thing In This World,1994,1994,0,1995,1
The Mummer's Dance,1998,1998,0,1998,0
The Mummers Dance,1998,1998,0,1998,0
The Mummers' Dance,1998,1998,0,1998,0
The Next Episode,2000,2000,0,2000,0
The Party Continues,1998,1998,0,1998,0
The Power Of Good-Bye,1998,1998,0,1980,18
The Real Slim Shady,2000,2000,0,2000,0
The Secret Of Life,1999,1999,0,1996,3
The Sound Of Your Voice,1991,1991,0,1991,0
The Space Between,2001,2001,0,2001,0
The Unforgiven,1992,1992,0,1992,0
The Way I Live,2007,2007,0,2007,0
The Whole World,2002,2002,0,2002,0
The Woman With You,2004,2004,0,2004,0
The Zephyr Song,2002,2002,0,2002,0
Theme From Mission: Impossible,1996,1996,0,1996,0
Theme From Mission:Impossible,1996,1996,0,1996,0
These Are The Times,1999,1999,0,2009,10
These Words,2005,2005,0,2005,0
They Want EFX,1992,1992,0,1992,0
Things'll Never Change/Rapper's Ball,1997,1997,0,1997,0
Thinking Of You,1997,1997,0,1997,0
Thinking Of You,1997,1997,0,1997,0
This Ain't A Scene It's An Arms Race,2007,2007,0,2007,0
This Is How We Do,2014,2014,0,2014,0
This Is Ponderous,1991,1991,0,1991,0
This Is Why I'm Hot,2007,2007,0,2007,0
This Kiss,1998,1998,0,1998,0
This Lil' Game We Play,1995,1995,0,1995,0
Thoia Thoing,2003,2003,0,2003,0
Three Little Pigs,1993,1993,0,1993,0
Three Little Pigs,1993,1993,0,1993,0
Throw It In The Bag,2009,2009,0,2009,0
Thug Lovin',2002,2002,0,2002,0
Thuggish Ruggish Bone,1994,1994,0,1994,0
Together Again,1998,1998,0,1980,18
Tom Ford,2013,2013,0,2012,1
Tonight Tonight,2011,2011,0,2011,0
Tonite,1991,1991,0,1991,0
Too Close,1998,1998,0,1980,18
Too Late Too Soon,1997,1997,0,1980,17
Too Much,1998,1998,0,1998,0
Too Much Information,1993,1993,0,1993,0
Top Back,2007,2007,0,2007,0
Torn,1998,1998,0,1998,0
Touch It,2006,2006,0,2006,0
Touch It,1998,1998,0,1998,0
Touch Me (All Night Long),1991,1991,0,1991,0
Touch Me Tease Me,1996,1996,0,1996,0
Touch The Sky,2006,2006,0,2006,0
Touchin Lovin,2014,2014,0,2014,0
Trap Queen,2015,2015,0,2015,0
Tremor Christ/Spin The Black Circle,1994,1994,0,1994,0
Tres Delinquentes,1996,1996,0,1996,0
Trophies,2014,2014,0,2010,4
Truly Madly Deeply,1998,1998,0,1980,18
Try Me,2014,2014,0,2014,0
Tubthumping,1997,1997,0,1997,0
Tuesday,2014,2014,0,2014,0
Turn It Up/Fire It Up,1998,1998,0,1998,0
Turn Up The Music,2012,2012,0,2012,0
Turn it Up,2005,2005,0,2005,0
Turtle Power,1990,1990,0,1990,0
Twilight Zone,1992,1992,0,1992,0
Two Teardrops,1999,1999,0,1999,0
Two Wrongs,2002,2002,0,2002,0
U Don't Know Me,2005,2005,0,2005,0
U Should've Known Better,2004,2004,0,2004,0
U Will Know,1994,1994,0,1994,0
U.O.E.N.O.,2013,2013,0,2013,0
Ugly,2001,2001,0,2001,0
Uh Huh,2002,2002,0,2002,0
Uma Thurman,2015,2015,0,2015,0
Unbelievable,1999,1999,0,1999,0
Unbreakable,2005,2005,0,2005,0
Unforgettable,1991,1991,0,1991,0
Up All Night,2010,2010,0,1985,25
Up Jumps Da Boogie,1997,1997,0,1997,0
Uprising,2009,2009,0,1990,19
Vibeology,1992,1992,0,1992,0
Victory,1998,1998,0,1998,0
Video,2001,2001,0,2002,1
Violet Hill,2008,2008,0,2002,6
Viva La Vida,2008,2008,0,2008,0
Vivrant Thing,1999,1999,0,1999,0
Wait A Minute,2001,2001,0,2001,0
Waka Waka (This Time For Africa),2010,2010,0,2010,0
Walk it Out,2006,2006,0,2006,0
Wannabe,1997,1997,0,1997,0
Warm It Up,1992,1992,0,1992,0
Wasted,2009,2009,0,2009,0
Wat Da Hook Gon Be,2003,2003,0,2003,0
Watch The Wind Blow By,2004,2004,0,2004,0
We Are The World 25,2010,2010,0,2010,0
We Be Burnin',2005,2005,0,2005,0
We Can't Be Friends,1999,1999,0,1999,0
We Like To Party!,1999,1999,0,1999,0
We Made You,2009,2009,0,2009,0
We No Speak Americano,2010,2010,0,2010,0
We R Who We R,2010,2010,0,2010,0
We Really Shouldn't Be Doing This,1998,1998,0,1998,0
We Run This,2006,2006,0,2009,3
We Takin' Over,2007,2007,0,2007,0
We Trying To Stay Alive,1997,1997,0,1997,0
We Want The Funk,1991,1991,0,1991,0
We're All In The Same Gang,1990,1990,0,1990,0
We're Not Making Love No More,1998,1998,0,2009,11
Welcome Back,2004,2004,0,2004,0
Welcome To Atlanta,2002,2002,0,2002,0
West Coast,2014,2014,0,2000,14
Westside,1998,1998,0,1998,0
Wetter (Calling You Daddy),2009,2009,0,2009,0
Wetter (Calling You Daddy),2009,2009,0,2009,0
What A Beautiful Day,2003,2003,0,2003,0
What About Us,1997,1997,0,1997,0
What Happened To That Boy,2003,2003,0,2003,0
What I've Been Looking For,2006,2006,0,1990,16
What If,1998,1998,0,1980,18
What It's Like,1999,1999,0,1999,0
What Them Girls Like,2008,2008,0,2008,0
What They Do,1997,1997,0,1997,0
What U Gon' Do,2004,2004,0,2004,0
What Would Happen,1998,1998,0,1998,0
What Ya Want,1999,1999,0,1999,0
What You Want,2000,2000,0,2009,9
What You Want,1998,1998,0,1998,0
What's Going On,2001,2001,0,2001,0
What's Happnin',2004,2004,0,2004,0
What's On Tonight,1997,1997,0,1996,1
What's So Different,1999,1999,0,2003,4
What's Up Doc? (Can We Rock),1993,1993,0,1993,0
What's Wrong With Them,2010,2010,0,1984,26
What's Your Fantasy,2000,2000,0,2000,0
Whataya Want From Me,2010,2010,0,2010,0
Whatcha Gone Do?,1998,1998,0,1998,0
Whatcha Wanna Do?,1998,1998,0,1998,0
Whateva Man,1997,1997,0,1997,0
Whatever,1997,1997,0,1980,17
Whatever You Like,2008,2008,0,2008,0
Whatever You Say,1999,1999,0,1999,0
Whe U See Is What U Get,1998,1998,0,2002,4
When I Think About Angels,2001,2001,0,2001,0
When The Last Time,2002,2002,0,2002,0
When The Sun Goes Down,2004,2004,0,2004,0
Where I Come From,2001,2001,0,2001,0
Where Is The Love?,2003,2003,0,2003,0
Where My Girls At?,1999,1999,0,1980,19
Where The Party At,2001,2001,0,2001,0
Where Them Girls At,2011,2011,0,2011,0
Where Ya At,2015,2015,0,2015,0
Wherever You Go,1998,1998,0,1980,18
Whine Up,2007,2007,0,2007,0
Whip My Hair,2010,2010,0,2010,0
White & Nerdy,2006,2006,0,2006,0
Who Am I,1998,1998,0,1998,0
Who Dat,1999,1999,0,1999,0
Who Dat,1999,1999,0,1999,0
Who Gon Stop Me,2011,2011,0,2009,2
Who Let The Dogs Out,2000,2000,0,2000,0
Who Wouldn't Wanna Be Me,2003,2003,0,2003,0
Who You Are,1996,1996,0,1996,0
Who's That Girl?,2001,2001,0,2001,0
Whoa!,2000,2000,0,2000,0
Whoomp! (There It Is),1993,1993,0,1993,0
Whoot There It Is,1993,1993,0,1993,0
Whutcha Want?,1995,1995,0,1997,2
Why Don't We Fall In Love,2002,2002,0,2002,0
Why?,2004,2004,0,2004,0
Wide Open Spaces,1998,1998,0,1998,0
Wifey,2000,2000,0,2000,0
Wild Horses,2001,2001,0,1998,3
Wild Night,1994,1994,0,1994,0
Wild Night,1994,1994,0,1994,0
Wild Ones,2012,2012,0,2012,0
Wild Wild Love,2014,2014,0,2014,0
Wild Wild West,1999,1999,0,1999,0
Wild Wild West,1999,1999,0,1999,0
Will 2K,1999,1999,0,1999,0
Wind It Up,2006,2006,0,2006,0
Wind Of Change,1991,1991,0,1991,0
Winner,2010,2010,0,2010,0
Wishlist,1998,1998,0,1998,0
Without Me,2002,2002,0,2002,0
Without You,2011,2011,0,2011,0
Wobble Wobble,2000,2000,0,2000,0
Womanizer,2008,2008,0,2008,0
Wonderful,1995,1995,0,1995,0
Wonderwall,1996,1996,0,1996,0
Woo-Hah!! Got You All In Check/Everything Remains Raw,1996,1996,0,1996,0
Woof Woof,1998,1998,0,1998,0
Word Crimes,2014,2014,0,2009,5
Work In Progress,2002,2002,0,2002,0
Work It,2002,2002,0,2002,0
Write This Down,1999,1999,0,1999,0
Written In The Stars,2011,2011,0,2011,0
XO,2014,2014,0,2014,0
YAHHH!,2008,2008,0,2005,3
Yeah Ya Know (Takers),2010,2010,0,2012,2
Yeah!,2004,2004,0,2004,0
Year 3000,2007,2007,0,2007,0
Yellow,2001,2001,0,2014,13
You Better Wait,1994,1994,0,1994,0
You Bring Me Up,1997,1997,0,1997,0
You Can't Play With My Yo-Yo,1991,1991,0,1991,0
You Don't Know,2006,2006,0,2006,0
You Give Love A Bad Name,2007,2007,0,1990,17
You Got It,1995,1995,0,1980,15
You Got Me,1999,1999,0,1999,0
You Had Me From Hello,1999,1999,0,1980,19
You Learn/You Oughta Know,1996,1996,0,1996,0
You Let Your Heart Go Too Fast,1994,1994,0,1994,0
You Make Me Feel...,2011,2011,0,2011,0
You Make Me Sick,2001,2001,0,2001,0
You Won't Forget Me,1998,1998,0,2003,5
You're A God,2001,2001,0,1980,21
You're A Jerk,2009,2009,0,2009,0
You're Beginning To Get To Me,1998,1998,0,2001,3
You're Easy On The Eyes,1998,1998,0,1998,0
You're Still The One,1998,1998,0,2004,6
Young,2002,2002,0,2002,0
Young'n (Holla Back),2002,2002,0,2002,0
Your Body,2005,2005,0,2005,0
Your Love,2010,2010,0,2010,0
Your Woman,1997,1997,0,1997,0
i,2014,2014,0,2014,0
808,1999,1998,1,1991,8
(God Must Have Spent) A Little More Time On You,1999,1998,1,1999,0
(You Drive Me) Crazy,1999,1998,1,1980,19
... Baby One More Time,1999,1998,1,1980,19
15 Minutes,1999,1998,1,1997,2
4 Seasons Of Loneliness,1997,1998,1,1989,8
456,1999,1998,1,2004,5
6 Underground,1997,1998,1,1994,3
A Night To Remember,1999,1998,1,1993,6
A Puro Dolor (Purest Of Pain),2000,2001,1,2003,3
ATLiens,1997,1998,1,2002,5
Ain't Nobody,1997,1998,1,1995,2
All By Myself,1997,1998,1,1991,6
All Cried Out,1997,1998,1,2005,8
All For You,1997,1998,1,1980,17
All I Do,1998,1999,1,1986,12
All I Have To Give,1999,1998,1,1980,19
All I Want,1997,1998,1,1980,17
All Night Long,1999,1998,1,2005,6
All Star,1999,1998,1,2004,5
All That I Can Say,1999,1998,1,1998,1
Almost Doesn't Count,1999,1998,1,1980,19
Alone,1997,1998,1,1980,17
American Woman,1999,1998,1,1980,19
Angel,1999,1998,1,1980,19
Angel Of Mine,1999,1998,1,2012,13
Anyone Else,1999,1998,1,2004,5
Anything But Down,1999,1998,1,2001,2
Anywhere,1999,1998,1,2006,7
At The Beginning,1998,1997,1,1980,18
Avenues,1997,1998,1,1991,6
Avenues,1997,1998,1,1991,6
Back 2 Good,1999,1998,1,1980,19
Back 2 Good,1999,1998,1,1980,19
Back That Thang Up,1999,2000,1,2007,8
Backyard Boogie,1997,1998,1,1993,4
Bailamos,1999,1998,1,2004,5
Barbie Girl,1997,1998,1,1988,9
Barely Breathing,1997,1998,1,1995,2
Beautiful Stranger,1999,1998,1,2000,1
Because Of You,1998,1997,1,1980,18
Believe,1999,1998,1,1980,19
Better Days (And The Bottom Drops Out),1999,1998,1,1995,4
Big Daddy,1997,1998,1,2006,9
Bills Bills Bills,1999,1998,1,2005,6
Bitch,1997,1998,1,1986,11
Bitter Sweet Symphony,1998,1999,1,1980,18
Black Balloon,1999,1998,1,1980,19
Bohemian Rhapsody,1992,1991,1,1980,12
Bohemian Rhapsody,1996,1997,1,1980,16
Bow Wow (That's My Name),2001,2000,1,2000,1
Break Ya Neck,2002,2001,1,2001,1
Breaking All The Rules,1997,1998,1,1980,17
Building A Mystery,1997,1998,1,1999,2
Bump Bump Bump,2003,2002,1,2002,1
Busy Man,1999,1998,1,1999,0
Butterfly,2001,2000,1,2005,4
Butterfly Kisses,1997,1998,1,1997,0
Butterfly Kisses,1997,1998,1,1997,0
C U When U Get There,1997,1998,1,1997,0
C'est La Vie,1999,1998,1,1999,0
Can I Get A...,1999,1998,1,1998,1
Caramel,2002,2001,1,2001,1
Change,1992,1991,1,1991,1
Changes,1999,1998,1,1998,1
Closer To Free,1996,1997,1,1980,16
Cold Rock A Party,1997,1998,1,1996,1
Come On,1997,1998,1,2006,9
Come See Me,1997,1998,1,1996,1
Count On Me,1996,1997,1,1980,16
Criminal,1997,1998,1,2004,7
Crush,1998,1999,1,1999,1
Cupid,1997,1998,1,1998,1
Da' Dip,1997,1998,1,1997,0
Dance (A$$),2012,2011,1,2011,1
Dance With Me,2001,2000,1,1990,11
Danger (Been So Long),2001,2000,1,2000,1
Desperately Wanting,1997,1998,1,2002,5
Do I Have To Say The Words?,1992,1991,1,1980,12
Do That...,2003,2002,1,2002,1
Don't Be Stupid (You Know I Love You),1998,1997,1,1997,1
Don't Cry For Me Argentina,1997,1998,1,2003,6
Don't Let Go (Love),1997,1998,1,1996,1
Don't Stop The Party,2013,2012,1,2012,1
Don't Wanna Lose You,1996,1997,1,2014,18
Drive Me Wild,1999,1998,1,1980,19
E.I.,2001,2000,1,2000,1
E.T.,2011,2010,1,2010,1
Encore,2005,2004,1,2004,1
Every Morning,1999,1998,1,1999,0
Every Time I Close My Eyes,1997,1998,1,2015,18
Everybody (Backstreet's Back),1998,1999,1,1980,18
Ex-Factor,1999,1998,1,1999,0
Fabulous,2003,2002,1,2002,1
Feel So Good,1997,1998,1,1997,0
Fergalicious,2007,2006,1,2006,1
Flood,1996,1997,1,1982,14
Fly Away,1999,1998,1,1998,1
Fly Like An Eagle,1997,1996,1,1996,1
Foolin' Around,1995,1994,1,1994,1
For A Little While,1999,2000,1,1980,19
For You,1997,1998,1,2000,3
Fortunate,1999,1998,1,1999,0
Free As A Bird,1996,1997,1,1997,1
Gas Pedal,2014,2013,1,2013,1
Genie In A Bottle,1999,1998,1,1998,1
Georgia,2006,2005,1,2005,1
Get Back,2005,2004,1,2004,1
Get Gone,1999,1998,1,1999,0
Get It Together,1997,1998,1,1980,17
Get it Together,1997,1998,1,1980,17
Getto Jam,1994,1993,1,1993,1
Ghetto Cowboy,1999,1998,1,1998,1
Ghetto Cowboy,1999,1998,1,1998,1
Gigolo,2004,2003,1,2003,1
Girl On TV,2000,1999,1,1999,1
Give It To You,1999,1998,1,1999,0
Go The Distance,1997,1998,1,1997,0
God Must Have Spent A Little More Time On You,1999,1998,1,1998,1
Going Back To Cali,1998,1997,1,1997,1
Gone Crazy,1999,1998,1,1980,19
Got To Get It,2000,1999,1,2010,10
Grillz,2006,2005,1,2005,1
Hanginaround,2000,1999,1,1999,1
Hard Knock Life (Ghetto Anthem),1999,1998,1,1998,1
Hard To Say I'm Sorry,1997,1998,1,1980,17
Have A Little Mercy,1997,1998,1,1986,11
Have You Ever?,1999,1998,1,1980,19
He Didn't Have To Be,1999,1998,1,1980,19
Heartbreak Hotel,1999,1998,1,1980,19
Heartbreak Hotel,1999,1998,1,1980,19
Hold On To Me,1999,1998,1,1980,19
Home,2013,2012,1,2012,1
Honey,1997,1998,1,1997,0
Hot Boyz,2000,1999,1,1999,1
Hot In Herre,2002,2001,1,1980,22
How Do I Live,1997,1998,1,1980,17
How Do I Live,1997,1998,1,1980,17
How Forever Feels,1999,1998,1,2002,3
How We Do,2005,2004,1,2004,1
How's It Going To Be,1998,1997,1,1997,1
I Belong To You (Every Time I See Your Face),1997,1998,1,1997,0
I Care 'Bout You,1997,1998,1,1994,3
I Do,1998,1997,1,1994,4
I Don't Ever Want To See You Again,1998,1997,1,1997,1
I Don't Wanna,2000,1999,1,1980,20
I Don't Want To Miss A Thing,1999,1998,1,1980,19
I Don't Want To/I Love Me Some Him,1997,1998,1,1980,17
I Knew I Loved You,2000,1999,1,1999,1
I Like Them Girls,2001,2000,1,2000,1
I Need To Know,1999,1998,1,1980,19
I Say A Little Prayer,1997,1998,1,1991,6
I Still Believe,1999,1998,1,2000,1
I Want It That Way,1999,1998,1,1980,19
I Will Remember You (Live),1999,1998,1,1980,19
I Wish,2001,2000,1,2000,1
I'll Be Missing You,1997,1998,1,1997,0
I'm Different,2013,2012,1,2012,1
I'm Not Feeling You,1997,1998,1,1980,17
I'm Not Giving You Up,1997,1998,1,1980,17
I'm Not Ready,1999,1998,1,1992,7
If I Could Turn Back The Hands Of Time,1999,1998,1,1999,0
If It Makes You Happy,1997,1996,1,1996,1
If You Had My Love,1999,2000,1,2005,6
If You Love Me,1999,1998,1,2012,13
Ignition,2003,2002,1,2002,1
In Da Club,2003,2002,1,2003,0
In My Bed,1997,1998,1,1980,17
In The Closet,1992,1991,1,1980,12
Invisible Man,1997,1998,1,1980,17
It Wasn't Me,2001,2000,1,2000,1
It's All About The Benjamins,1998,1997,1,1997,1
It's All About You (Not About Me),1999,1998,1,1980,19
It's No Good,1997,1998,1,1992,5
It's Your Body,1997,1998,1,1997,0
It's Your Love,1997,1998,1,1980,17
Jam,1992,1991,1,1980,12
Janie's Got A Gun,1990,1991,1,1980,10
Jesus To A Child,1996,1997,1,1980,16
Jumper,1999,1998,1,1998,1
Just Another Day In Paradise,2000,2001,1,2000,0
Just Be A Man About It,2000,1999,1,2003,3
Just Dance,2009,2008,1,2008,1
Kickstart My Heart,1990,1989,1,1989,1
Kiss Me,1999,2000,1,1999,0
Laffy Taffy,2006,2005,1,2005,1
Last Night's Letter,1997,1998,1,1990,7
Lesson In Leavin',1999,1998,1,1999,0
Let Me Let Go,1998,1999,1,2012,14
Let's Get Married,2000,1999,1,2000,0
Let's Make A Night To Remember,1996,1997,1,1983,13
Lifestyles Of The Rich And Famous,2003,2002,1,2002,1
Liquid Dreams,2001,2000,1,2000,1
Livin' La Vida Loca,1999,2000,1,1999,0
Lollipop (Candyman),1998,1999,1,1980,18
Lonely And Gone,1999,1998,1,1999,0
Love Don't Cost A Thing,2001,2000,1,2001,0
Lovers And Friends,2005,2004,1,2004,1
Low,2008,2007,1,2007,1
Lucky Love,1996,1997,1,1980,16
Lullaby,1999,1998,1,1998,1
Macarena,1996,1995,1,1995,1
Macarena (Bayside Boys Mix),1996,1995,1,1995,1
Made You Look,2003,2002,1,2002,1
Magic Stick,2003,2002,1,2003,0
Mambo No. 5 (A Little Bit Of?),1999,2000,1,2007,8
Meet Virginia,2000,1999,1,1999,1
Miami,1999,1998,1,1998,1
Ms. Jackson,2001,2000,1,2000,1
Music Of My Heart,1999,1998,1,1980,19
My Body,1997,1998,1,1997,0
My First Night With You,1999,1998,1,1980,19
My Love Is The Shhh!,1997,1998,1,1995,2
My Love is The Shhh!,1997,1998,1,1995,2
Never Let You Go,2000,1999,1,2000,0
Never Make A Promise,1997,1998,1,1980,17
New Age Girl,1995,1994,1,1994,1
New York,2005,2004,1,2004,1
No Hands,2011,2010,1,2010,1
No More (Baby I'ma Do Right),2001,2000,1,2000,1
No One Else,1996,1997,1,1995,1
No Place That Far,1999,1998,1,1980,19
No Scrubs,1999,1998,1,1980,19
No Time,1997,1996,1,1996,1
No Worries,2013,2012,1,2012,1
No No No,1998,1997,1,1997,1
Nobody,1996,1997,1,1980,16
Nobody's Supposed To Be Here,1998,1997,1,1980,18
Not Gon' Cry,1996,1997,1,2007,11
Nothin' But The Cavi Hit,1997,1996,1,1996,1
Numb/Encore,2005,2004,1,2004,1
On My Own,1997,1998,1,1980,17
One More Time,1997,1998,1,1980,17
One More Try,1999,1998,1,1980,19
One Of Us,1996,1997,1,2011,15
Only You,1996,1997,1,1980,16
Ooh Aah...Just A Little Bit,1997,1998,1,1980,17
Ordinary Life,1999,1998,1,2004,5
Piece Of Me,2008,2007,1,2007,1
Please Don't Go,1997,1998,1,1980,17
Pony,1996,1997,1,1995,1
Powerful Thing,1999,1998,1,2001,2
Praise You,1999,1998,1,1980,19
Pushin' Weight,1999,1998,1,1998,1
Quit Playing Games (With My Heart),1997,1998,1,1980,17
Raise Your Glass,2011,2010,1,2010,1
Raise Your Glass,2011,2010,1,2010,1
Reach,1996,1997,1,1980,16
Real Love,1996,1997,1,1980,16
Real Muthaphuckkin G's,1994,1993,1,1993,1
Red Solo Cup,2012,2011,1,2011,1
Remember The Time,1992,1991,1,1980,12
Return Of The Mack,1997,1998,1,1980,17
Right On The Money,1999,2000,1,1980,19
Riptide,2015,2014,1,2014,1
Rock And A Hard Place,1990,1989,1,1989,1
Run,2001,2000,1,1986,15
Sadeness Part 1,1991,1990,1,1980,11
Save Tonight,1999,1998,1,1980,19
Say You'll Be There,1997,1998,1,1992,5
Say...If You Feel Alright,1997,1998,1,1997,0
Set U Free,1996,1995,1,1995,1
Sex And Candy,1998,1999,1,1998,0
Sexy And I Know It,2012,2011,1,2011,1
Shake Your Bon-Bon,2000,1999,1,1999,1
She's All I Ever Had,1999,1998,1,1980,19
Short Dick Man,1995,1994,1,1994,1
Show Me Love,1997,1998,1,1980,17
Sittin' Up In My Room,1996,1995,1,1995,1
Sitting Home,1999,1998,1,1980,19
Slow Jamz,2004,2003,1,2003,1
Smile,1999,1998,1,2013,14
Smooth,2000,1999,1,1999,1
So Help Me Girl,1997,1998,1,1980,17
Soldier,2005,2004,1,2004,1
Someday,2004,2003,1,2003,1
Someday,1999,1998,1,1999,0
Sometimes,1999,1998,1,1980,19
Somewhere Out There,2002,2001,1,1980,22
Stand Beside Me,1999,1998,1,1984,15
Staring At The Sun,1997,1998,1,1997,0
Stay The Night,2014,2013,1,2013,1
Stay The Same,1999,1998,1,1980,19
Step By Step,1997,1998,1,1985,12
Street Dreams,1997,1996,1,1996,1
Stupid Girl,1996,1997,1,1980,16
Sukiyaki,1995,1996,1,2008,13
Sunny Came Home,1997,1996,1,1997,0
Sweet Lady,1999,1998,1,1980,19
Swing The Mood,1990,1989,1,1989,1
Take A Picture,2000,1999,1,1999,1
Take Me There,1999,1998,1,1998,1
Taking Everything,1999,1998,1,1991,8
Talk To Me,1997,1998,1,1980,17
Team,2014,2013,1,2013,1
Telephone,2010,2009,1,2009,1
Telephone,2010,2009,1,2009,1
Tell Me It's Real,1999,1998,1,1980,19
Thank God I Found You,2000,1999,1,2000,0
The Animal Song,1999,1998,1,2011,12
The Chain Of Love,2000,1999,1,2000,0
The Day The World Went Away,1999,1998,1,1993,6
The Earth The Sun The Rain,1996,1997,1,1980,16
The Hardest Thing,1999,1998,1,1999,0
The Little Girl,2000,1999,1,1980,20
The Motto,2012,2011,1,2011,1
The One I Gave My Heart To,1997,1998,1,1980,17
The Other Side,1990,1991,1,1980,10
The Shoop Shoop Song (It's In His Kiss),1991,1990,1,1990,1
The Way You Move,2004,2003,1,2003,1
Then The Morning Comes,2000,1999,1,1999,1
There Will Never Be Another Tonight,1992,1991,1,1980,12
There You Have It,1999,1998,1,1998,1
There You Have It,1999,1998,1,1998,1
There's Your Trouble,1998,1999,1,1980,18
They Don't Know,1998,1999,1,1980,18
They Don't Know,1998,1999,1,1980,18
Thinkin' 'Bout It,1998,1997,1,2011,13
Thirty-Three,1997,1996,1,1996,1
This Is Your Night,1997,1996,1,1996,1
This Time Around,2000,1999,1,2000,0
Thong Song,2000,1999,1,2008,8
Thought I'd Died And Gone To Heaven,1992,1991,1,1980,12
Thrift Shop,2013,2012,1,2012,1
Through The Wire,2004,2003,1,2003,1
Thugz Mansion,2002,2001,1,2002,0
Tie Me Down,2010,2009,1,2009,1
Time After Time,1998,1997,1,1981,17
To Make You Feel My Love,1997,1998,1,1980,17
To The Moon And Back,1998,1997,1,1997,1
Tonight The Heartache's On Me,1999,1998,1,1987,12
Tonite's Tha Night,1996,1995,1,1995,1
Too Gone Too Long,1997,1998,1,1998,1
Too Hot,1996,1995,1,1995,1
Tootsee Roll,1995,1994,1,1994,1
Trade It All,2002,2001,1,2002,0
Trippin',1999,1998,1,1993,6
Turn It Up,2006,2005,1,2005,1
U Know What's Up,1999,2000,1,2006,7
Un-Break My Heart,1996,1997,1,1996,0
Unpretty,1999,1998,1,2011,12
Until I Find You Again,1997,1998,1,1980,17
Use Your Heart,1996,1997,1,1998,2
Valentine,1997,1998,1,1988,9
Visions Of A Sunset,1996,1995,1,1995,1
Waiting For Tonight,1999,1998,1,2002,3
Walk It Out,2007,2006,1,2006,1
Wanksta,2003,2002,1,2002,1
We Thuggin',2002,2001,1,2001,1
What A Girl Wants,2000,1999,1,1980,20
What It Takes,1990,1991,1,1980,10
What Kind Of Man Would I Be,1996,1997,1,1996,0
What'Chu Like,2000,1999,1,1991,9
What's It Gonna Be?!,1999,1998,1,1999,0
What's Love Got To Do With It,1996,1997,1,1980,16
What's My Name?,1994,1993,1,1993,1
Whatever,2000,1999,1,2006,6
When A Woman's Fed Up,1999,1998,1,1999,0
When I Close My Eyes,1999,1998,1,1980,19
When I Die,1997,1998,1,1980,17
When The Lights Go Out,1998,1997,1,1980,18
When The Night Comes,1990,1991,1,1980,10
When You're Gone/Free To Decide,1997,1996,1,1996,1
Where Do You Go,1996,1995,1,2001,5
Where The Blacktop Ends,2001,2002,1,2002,1
Who I Am,2001,2000,1,2002,1
Why I Love You So Much/Ain't Nobody,1996,1997,1,1996,0
Why I Love you So Much/Ain't Nobody,1996,1997,1,1996,0
Wild Night,1995,1994,1,1994,1
Wish You Were Here,1999,1998,1,1994,5
With You,1999,1998,1,1980,19
Without Love,1997,1998,1,2010,13
Wonder,1996,1995,1,1995,1
Wonderful,2000,1999,1,1980,20
Work Out,2012,2011,1,2011,1
Written In The Stars,1999,1998,1,1999,0
You Are Not Alone,1995,1996,1,1980,15
You Are not Alone,1995,1996,1,1980,15
You Can Do It,2000,1999,1,1999,1
You Don't Have To Hurt No More,1997,1998,1,1991,6
You Don't Know My Name,2004,2003,1,2003,1
You Get What You Give,1999,1998,1,1998,1
You Light Up My Life,1997,1998,1,1980,17
You Should Be Mine (Don't Waste Your Time),1997,1998,1,1997,0
You Were Mine,1999,1998,1,1980,19
You Won't Ever Be Lonely,1999,1998,1,1980,19
You'll Be In My Heart,1999,1998,1,1980,19
You've Got A Way,1999,1998,1,1980,19
Your Loving Arms,1996,1997,1,1980,16
911,2000,1998,2,2002,2
1979,1996,1998,2,2011,15
(Hot S**t) Country Grammar,2000,2002,2,2002,2
1234 (Sumpin' New),1996,1998,2,1998,2
5 O'Clock,1996,1998,2,1994,2
A Thin Line Between Love & Hate,1996,1998,2,1980,16
AM To PM,2001,1999,2,2004,3
Aaron's Party (Come Get It),2000,1998,2,2006,6
Ain't No Nigga/Dead Presidents,1996,1998,2,2004,8
All The Small Things,2000,1998,2,1980,20
All The Things (Your Man Won't Do),1996,1998,2,1980,16
Always Be My Baby,1996,1998,2,2009,13
Amazed,2000,1998,2,1980,20
American Pie,2000,1998,2,2015,15
Another Dumb Blonde,2000,1998,2,1985,15
Anything,1996,1998,2,1980,16
Ascension (Don't Ever Wonder),1996,1998,2,2015,19
Auld Lang Syne,2000,1998,2,2011,11
Back At One,2000,1998,2,1980,20
Back At One,2000,1998,2,1980,20
Back Here,2000,1998,2,1980,20
Back To The World,1996,1998,2,1980,16
Bag Lady,2000,1998,2,1994,6
Be My Lover,1996,1998,2,2013,17
Be With You,2000,1998,2,1980,20
Because You Loved Me,1996,1998,2,1980,16
Been There,2000,1998,2,1980,20
Bent,2000,1998,2,1984,16
Best Of Me,2000,1998,2,2008,8
Between Me And You,2000,1998,2,1980,20
Beware Of The Boys (Mundian To Bach Ke),2003,2001,2,2009,6
Big Deal,2000,1998,2,1980,20
Birmingham,1996,1998,2,2001,5
Bittersweet Me,1996,1998,2,1994,2
Blood On The Dance Floor,1997,1999,2,1984,13
Blue,1996,1998,2,1980,16
Blue (Da Ba Dee),2000,1998,2,1980,20
Bounce With Me,2000,1998,2,1996,4
Breakfast At Tiffany's,1996,1998,2,1995,1
Breathe,2000,1998,2,1980,20
Bring It All To Me,2000,1998,2,2001,1
Broadway,2000,1998,2,1980,20
Brokenhearted,1995,1997,2,1980,15
Bullet With Butterfly Wings,1996,1998,2,2011,15
Butta Love,1997,1999,2,2006,9
Buy Me A Rose,2000,1998,2,1980,20
Bye Bye Bye,2000,1998,2,1980,20
Can I Touch You...There?,1995,1997,2,1980,15
Candy,1999,1997,2,1999,0
Carnival,1995,1997,2,1995,0
Case Of The Ex (Whatcha Gonna Do),2000,1998,2,1999,1
Chains,1996,1998,2,1980,16
Change The World,1996,1998,2,1980,16
Come On Over Baby (All I Want Is You),2000,1998,2,1992,8
Couldn't Last A Moment,2000,1998,2,1980,20
Counting Blue Cars,1996,1998,2,1980,16
Crash And Burn,2000,1998,2,1980,20
Crybaby,2000,1998,2,2000,0
Cryin',1993,1991,2,1980,13
Dance Into The Light,1996,1998,2,1980,16
Dance Tonight,2000,1998,2,2000,0
Dancin',2000,1998,2,1980,20
Differences,2001,1999,2,2001,0
Do You Miss Me,1996,1998,2,1980,16
Do You Want To/Can't Hang,1996,1998,2,1980,16
Doesn't Really Matter,2000,1998,2,2000,0
Don't Say You Love Me,2000,1998,2,2003,3
Don't Think I'm Not,2000,1998,2,2000,0
Down A** Chick,2002,2000,2,2002,0
Down Low (Nobody Has To Know),1996,1998,2,1980,16
Dreaming Of You,1995,1997,2,1995,0
Drive (For Daddy Gene),2002,2000,2,2002,0
Everything You Want,2000,1998,2,2000,0
Faded,2000,1998,2,2000,0
Fantasy,1995,1997,2,1980,15
Fastlove,1996,1998,2,1996,0
Feels So Good,1996,1998,2,1980,16
Feels So Good (Show Me Your Love),1996,1998,2,1980,16
Floatin' On Your Love,1996,1998,2,1980,16
Follow You Down/Til I Hear It From You,1996,1998,2,1986,10
Free,2001,1999,2,2000,1
From The Bottom Of My Broken Heart,2000,1998,2,1980,20
G.H.E.T.T.O.U.T.,1997,1999,2,1997,0
Get It On Tonite,2000,1998,2,1980,20
Get Ready For This,1995,1997,2,1992,3
Get Together,1996,1998,2,1999,3
Glycerine,1996,1998,2,1996,0
Go On,2000,1998,2,1999,1
Gotta Tell You,2000,1998,2,1980,20
Graduation (Friends Forever),2000,1998,2,2000,0
Hands Of A Working Man,1999,1997,2,2001,2
He Can't Love U,2000,1998,2,1980,20
He Wasn't Man Enough,2000,1998,2,1997,3
Heal The World,1993,1991,2,1980,13
Heaven,1995,1997,2,1980,15
Higher,2000,1998,2,1980,20
Hold Me,1999,1997,2,1980,19
Hold Me Thrill Me Kiss Me Kill Me,1995,1997,2,1995,0
Hook,1996,1998,2,1995,1
House Of Love,1995,1997,2,1980,15
How Do You Like Me Now?!,2000,1998,2,1980,20
How You Remind Me,2001,1999,2,1980,21
I Believe I Can Fly,1996,1998,2,1980,16
I Can't Sleep Baby (If I),1996,1998,2,1980,16
I Could Not Ask For More,1999,1997,2,1980,19
I Do (Cherish You),1999,1997,2,2007,8
I Don't Have To Be Me ('Til Monday),2002,2000,2,1980,22
I Feel You,1993,1995,2,1980,13
I Finally Found Someone,1996,1998,2,1996,0
I Learned From The Best,2000,1998,2,1980,20
I Like,1996,1998,2,1997,1
I Lost It,2000,1998,2,1980,20
I Need You,2000,1998,2,1980,20
I Remember,1996,1998,2,1980,16
I Think I'm In Love With You,2000,1998,2,1980,20
I Try,2000,1998,2,1980,20
I Turn To You,2000,1998,2,1981,19
I Wanna Be With You,2000,1998,2,2008,8
I Wanna Know,2000,1998,2,1980,20
I Wanna Love You Forever,2000,1998,2,1999,1
I Want To Come Over,1996,1998,2,1980,16
I Will Come To You,1997,1999,2,1980,17
I Will Get There,1999,1997,2,1981,18
I Will Survive,1996,1998,2,1996,0
I Wish,2000,1998,2,2000,0
I'm A Survivor,2001,1999,2,1994,7
I'm Just Talkin' About Tonight,2001,1999,2,2005,4
I'm Still In Love With You,1997,1999,2,1980,17
If I Ever Lose My Faith In You,1993,1991,2,1980,13
If Your Girl Only Knew,1996,1998,2,2000,4
In The Meantime,1996,1998,2,1996,0
Incomplete,2000,1998,2,2006,6
Insensitive,1996,1998,2,1996,0
Insensitve,1996,1998,2,1996,0
Ironic,1996,1998,2,1996,0
It Feels So Good,2000,1998,2,2006,6
It Must Be Love,2000,1998,2,1998,2
It's A Great Day To Be Alive,2001,1999,2,2001,0
It's All Coming Back To Me Now,1996,1998,2,1980,16
It's All The Way Live (Now),1996,1998,2,1994,2
It's Gonna Be Me,2000,1998,2,2000,0
Jumpin' Jumpin',2000,1998,2,1998,2
Just Friends (Sunny),2000,1998,2,2000,0
Kryptonite,2000,1998,2,2013,13
Lately,1993,1991,2,1980,13
Lessons Learned,2000,1998,2,2002,2
Let's Go,2004,2002,2,2004,0
Let's Go (2004),2004,2002,2,2004,0
Lights Camera Action!,2002,2000,2,2001,1
Like A Woman,1996,1998,2,1996,0
Like I Love You,2002,2000,2,2002,0
Livin' On The Edge,1993,1991,2,1980,13
Love Is Blind,2000,1998,2,1991,9
Love U 4 Life,1996,1998,2,1980,16
Love's The Only House,2000,1998,2,2001,1
Machinehead,1996,1998,2,1987,9
Make It Hot,1998,2000,2,2001,3
Make It Hot,1998,2000,2,2001,3
Make It Hot,1998,2000,2,2001,3
Missing,1996,1998,2,1986,10
Missing You,1996,1998,2,1980,16
Missing You,1996,1998,2,1980,16
More Than This,1997,1995,2,1980,17
Movin On,1998,2000,2,1997,1
Movin' On,1998,2000,2,1997,1
Music,2001,1999,2,2010,9
My Best Friend,2000,1998,2,1980,20
My Boo,1996,1998,2,1996,0
My First Love,2000,1998,2,1985,15
My Love Is For Real,1995,1997,2,1980,15
My Love Is Your Love,2000,1998,2,2009,9
My Next Thirty Years,2000,1998,2,2000,0
Name,1996,1998,2,1995,1
Natural One,1996,1998,2,1995,1
Never Alone (Eeyore's Lullaby),1995,1993,2,1988,7
No More,2000,1998,2,2000,0
Nobody Knows,1996,1998,2,1980,16
None Of Ur Friends Business,2000,1998,2,2000,0
Now And Forever,1994,1996,2,1980,14
Nowhere To Go,1996,1998,2,1980,16
Old Man & Me (When I Get To Heaven),1996,1998,2,1996,0
One More Day,2001,1999,2,1980,21
One Night Stand,2000,1998,2,2000,0
One Voice,2000,1998,2,2000,0
Only In America,2001,1999,2,2001,0
Only Love (The Ballad Of Sleeping Beauty),1996,1998,2,1995,1
Oops!...I Did It Again,2000,1998,2,1980,20
Otherside,2000,1998,2,2000,0
Pinch Me,2000,1998,2,2000,0
Play,2001,1999,2,1980,21
Please Don't Go,1996,1998,2,1980,16
Please Remember Me,1999,1997,2,1982,17
Pop A Top,2000,1998,2,2000,0
Prayer For The Dying,1994,1996,2,1994,0
Redneck Woman,2004,2002,2,2011,7
Remember When,1998,1996,2,1997,1
Ridin' Low,1996,1998,2,1996,0
Rock The Boat,2001,1999,2,1980,21
Rollout (My Business),2002,2000,2,2001,1
Say My Name,2000,1998,2,1980,20
Separated,2000,1998,2,1980,20
She Bangs,2000,1998,2,2009,9
She's All I Got,2001,1999,2,2001,0
She's More,2000,1998,2,2000,0
Somebody To Love,1993,1991,2,1980,13
Someday Out Of The Blue,2000,1998,2,1986,14
Something Like That,1999,1997,2,1999,0
Soon As I Get Home,1996,1998,2,1980,16
Spend My Life With You,1999,1997,2,1980,19
Splash Waterfalls,2004,2002,2,2004,0
Stay The Night,1999,1997,2,1996,3
Swear It Again,2000,1998,2,1980,20
Sweet Dreams,1996,1998,2,2009,13
Tell Her,2001,1999,2,2000,1
Tell Me (I'll Be Around),1996,1998,2,2002,6
Thank You,2001,1999,2,2001,0
That Don't Impress Me Much,1999,1997,2,2000,1
That Thing You Do!,1996,1998,2,1980,16
That'd Be Alright,2003,2001,2,2003,0
That's The Way,2000,1998,2,1980,20
The 13th,1996,1998,2,1994,2
The Christmas Shoes,2001,1999,2,2009,8
The Good Stuff,2002,2000,2,2002,0
The One,2000,1998,2,1980,20
The Things That You Do,1996,1998,2,1996,0
The Way You Love Me,2001,1999,2,1980,21
There She Goes,1999,1997,2,1997,2
There You Go,2000,1998,2,2000,0
There You'll Be,2001,1999,2,1980,21
This Ain't A Love Song,1995,1997,2,2015,20
This I Promise You,2000,1998,2,1998,2
Time,1996,1998,2,1980,16
Tonight Tonight,1996,1998,2,1992,4
Touch Myself,1996,1998,2,1980,16
Try Again,2000,1998,2,1980,20
Twisted,1996,1998,2,2002,6
Unconditional,2000,1998,2,1980,20
Until The End Of Time,1995,1997,2,1980,15
Watch Me Do My Thing,1997,1999,2,1997,0
Water Runs Dry,1995,1997,2,1980,15
We Got It,1996,1998,2,1997,1
Welcome Back,2004,2002,2,2004,0
What About Now,2000,1998,2,2012,12
What Do You Say,2000,1998,2,1985,15
What It Feels Like For A Girl,2001,1999,2,2005,4
When I Said I Do,1999,1997,2,1994,5
When You Love A Woman,1996,1998,2,1980,16
Where Do U Want Me To Put It,1996,1998,2,1995,1
Where Do We Go From Here,1996,1998,2,1980,16
Where I Wanna Be,2000,1998,2,2000,0
Who Can I Run To,1995,1997,2,1985,10
Who Do U Love,1996,1998,2,1980,16
Who Is It,1993,1991,2,1980,13
Who's Your Daddy?,2002,2000,2,2002,0
Why Does It Hurt So Bad,1996,1998,2,1994,2
Will You Be There,1993,1991,2,1980,13
Without You,2000,1998,2,1980,20
Wrapped Up In You,2001,1999,2,1980,21
Wrong Again,1999,1997,2,1980,19
Yes!,2000,1998,2,1980,20
You,1999,1997,2,1980,19
You,1996,1998,2,1980,16
You Gotta Be,1995,1997,2,1994,1
You Make Me Wanna...,1997,1999,2,1980,17
You Must Love Me,1996,1998,2,1981,15
You Sang To Me,2000,1998,2,1980,20
You're Makin' Me High/Let It Flow,1996,1998,2,1996,0
You're The One,1996,1998,2,1980,16
#1,2001,1998,3,1980,21
' Til You Do Me Right,1995,1998,3,1980,15
(She's) Some Kind Of Wonderful,1994,1997,3,2004,10
19 Somethin',2003,2000,3,2010,7
A Girl Like You,1995,1998,3,2011,16
A Long Walk,2001,1998,3,1986,15
Absolutely (Story Of A Girl),2000,1997,3,1980,20
After Party,2001,1998,3,1980,21
Again,2001,1998,3,1980,21
Ain't Nothing 'Bout You,2001,1998,3,1980,21
Ain't Nuthin' But A She Thing,1995,1998,3,1994,1
All For Love,1994,1997,3,1994,0
All For You,2001,1998,3,2006,5
All Or Nothing,2001,1998,3,1991,10
Always,1994,1997,3,1980,14
Amazing,1994,1991,3,1980,14
Angel,2001,1998,3,1999,2
Angry All The Time,2001,1998,3,1980,21
Any Man Of Mine/ Whose Bed Have Your Boots Been Under,1995,1998,3,1980,15
Area Codes,2001,1998,3,1998,3
Around The World (La La La La La),2001,1998,3,1980,21
As I Lay Me Down,1995,1998,3,1984,11
Ashes By Now,2001,1998,3,1980,21
Ask Of You,1995,1998,3,1980,15
Austin,2001,1998,3,1983,18
Axel F,2005,2002,3,1991,14
Baby,1995,1998,3,1980,15
Baby I Love Your Way,1994,1997,3,1997,3
Baby Come Over (This Is Our Night),2001,1998,3,1980,21
Back For Good,1995,1998,3,1980,15
Backwater,1994,1997,3,2014,20
Bad Boy For Life,2001,1998,3,2001,0
Bang And Blame,1995,1998,3,2013,18
Be Like That,2001,1998,3,1980,21
Beautiful Day,2001,1998,3,2002,1
Beautiful In My Eyes,1994,1997,3,1980,14
Beautiful Life,1995,1998,3,1980,15
Because I Got High,2001,1998,3,2012,11
Bedtime Story,1995,1998,3,2002,7
Before I Let You Go,1995,1998,3,1980,15
Before You Walk Out Of My Life/Like This And Like That,1995,1998,3,1980,15
Believe,1995,1998,3,1993,2
Best Friend,1995,1998,3,1996,1
Best Of Intentions,2000,1997,3,1980,20
Big Poppa/Warning,1995,1998,3,2002,7
Big Poppa/Warning,1995,1998,3,2002,7
Blessed,1995,1998,3,1980,15
Blessed,1995,1998,3,1980,15
Blind Man,1994,1991,3,1980,14
Bling Bling,1999,2002,3,2012,13
Body & Soul,1994,1997,3,1980,14
Bootylicious,2001,1998,3,2001,0
Breathless,2001,1998,3,1980,21
Brown Sugar,1995,1998,3,1995,0
But For The Grace Of God,2001,1998,3,2001,0
C'Mon N' Ride It (The Train),1996,1999,3,1996,0
C'mon N' Ride It (The Train),1996,1999,3,1996,0
Can You Feel The Love Tonight,1994,1997,3,1994,0
Can't Cry Anymore,1995,1998,3,1989,6
Can't Stop Lovin' You,1995,1998,3,1980,15
Candy Rain,1995,1998,3,1980,15
Close To You,1995,1998,3,1995,0
Come And Get Your Love,1995,1998,3,1996,1
Come With Me,1995,1998,3,1980,15
Comedown,1995,1998,3,1980,15
Constantly,1995,1998,3,1980,15
Contagious,2001,1998,3,2001,0
Cotton Eye Joe,1995,1998,3,1995,0
Cowboy Take Me Away,2000,1997,3,2000,0
Crazy,1994,1991,3,1980,14
Crazy,2001,1998,3,2000,1
Crazy For This Girl,2001,1998,3,1980,21
Crazy Love,1995,1998,3,1980,15
Creep,1995,1998,3,1994,1
Dance With Me,2001,1998,3,2000,1
December,1995,1998,3,1995,0
Dig In,2001,1998,3,2011,10
Diggin' On You,1995,1998,3,1992,3
Do You Sleep?,1995,1998,3,2000,5
Doin It,1996,1999,3,1996,0
Don't Happen Twice,2001,1998,3,1980,21
Don't Take It Personal (Just One Of Dem Days),1995,1998,3,1980,15
Don't Tell Me,2001,1998,3,2000,1
Downtime,2001,1998,3,1990,11
Downtown Venus,1995,1998,3,2005,10
Dream About You/Funky Melody,1995,1998,3,1980,15
Drive,2001,1998,3,1983,18
Drowning,2001,1998,3,1980,21
Emotion,2001,1998,3,1980,21
Everlasting Love,1995,1998,3,1980,15
Every Day Of The Week,1995,1998,3,1980,15
Every Little Thing I Do,1995,1998,3,1980,15
Every Other Time,2001,1998,3,2001,0
Everywhere,2001,1998,3,2001,0
Exhale (Shoop Shoop),1995,1998,3,1994,1
Fade Into You,1994,1997,3,1980,14
Fallin',2001,1998,3,1980,21
Falling,1996,1999,3,2003,7
Falls Apart,2000,1997,3,2000,0
Family Affair,2001,1998,3,2001,0
Far Behind,1994,1997,3,1980,14
Feel The Funk,1995,1998,3,1995,0
Feelin' On Yo Booty,2001,1998,3,2001,0
Feels So Good,1995,1998,3,1988,7
Fields Of Gold,1993,1990,3,1980,13
Fill Me In,2001,1998,3,2001,0
Flavor Of The Weak,2001,1998,3,1989,12
Follow Me,2001,1998,3,1980,21
Forever In Love,1993,1990,3,1980,13
Freak Like Me,1995,1998,3,1995,0
Freek'n You,1995,1998,3,1995,0
Get On Up,1996,1999,3,1980,16
Get Over Yourself,2001,1998,3,1980,21
Get The Party Started,2001,1998,3,2001,0
Give It 2 You,1995,1998,3,1995,0
Gone,2001,1998,3,2001,0
Good,1995,1998,3,1980,15
Grapevyne,1995,1998,3,1980,15
Grown Men Don't Cry,2001,1998,3,2010,9
Have You Ever Really Loved A Woman?,1995,1998,3,1980,15
He's Mine,1995,1998,3,1995,0
Heard It All Before,2001,1998,3,1998,3
Hemorrhage (In My Hands),2001,1998,3,1980,21
Here's To The Night,2001,1998,3,1980,21
Hero,1993,1996,3,1980,13
Hit 'Em Up Style (Oops!),2001,1998,3,2001,0
Hit Me Off,1996,1999,3,2010,14
Hold My Hand,1995,1998,3,1980,15
Hold On,1995,1998,3,1980,15
How Do U Want It/California Love,1996,1999,3,1996,0
Human Nature,1995,1998,3,1995,0
Husbands And Wives,1998,2001,3,1984,14
I Believe,1995,1998,3,2013,18
I Belong To You/How Many Ways,1995,1998,3,1980,15
I Can Love You Like That,1995,1998,3,1995,0
I Could Not Ask For More,2001,1998,3,1980,21
I Cry,2001,1998,3,2001,0
I Got Id/Long Road,1996,1999,3,1980,16
I Know,1995,1998,3,1980,15
I Like,1995,1998,3,1980,15
I Like It I Love It,1995,1998,3,2009,14
I Live My Life For You,1995,1998,3,1980,15
I Miss You,1995,1998,3,1980,15
I Need A Girl (Part One),2002,1999,3,2002,0
I Need A Girl (Part Two),2002,1999,3,2002,0
I Never Seen A Man Cry (aka I Seen A Man Die),1995,1998,3,1994,1
I Swear,1994,1997,3,1980,14
I Wanna B With U,1995,1998,3,1995,0
I Wanna Be Bad,2001,1998,3,1980,21
I Will Love Again,2000,1997,3,1980,20
I Would've Loved You Anyway,2001,1998,3,1980,21
I'd Lie For You (And That's The Truth),1995,1998,3,1980,15
I'd Rather Be Alone,1995,1998,3,1980,15
I'll Be Around,1995,1998,3,1995,0
I'll Be There For You/This House Is Not A Home,1995,1998,3,1980,15
I'll Be There For You/You're All I Need To Get By,1995,1998,3,1995,0
I'll Be There For You/You're All I Need To Get By,1995,1998,3,1995,0
I'll Be There For You/You're All I Need To Get By,1995,1998,3,1995,0
I'll BeThere For You/This House Is Not A Home,1995,1998,3,1980,15
I'll Stand By You,1994,1997,3,1980,14
I'm A Slave 4 U,2001,1998,3,2001,0
I'm Already There,2001,1998,3,2009,8
I'm Goin' Down,1995,1998,3,1981,14
I'm Gonna Miss Her (The Fishin' Song),2002,1999,3,1994,8
I'm Real,2001,1998,3,1980,21
I'm The Only One,1995,1998,3,1980,15
I'm Tryin',2001,1998,3,2001,0
If I Fall You're Going Down With Me,2001,1998,3,2001,0
If I Wanted To/Like The Way I Do,1995,1998,3,1980,15
If My Heart Had Wings,2001,1998,3,1990,11
If You Think You're Lonely Now,1995,1998,3,1980,15
If You're Gone,2001,1998,3,1994,7
In The Still Of The Nite,1993,1996,3,2015,22
Irresistible,2001,1998,3,2001,0
It's Been Awhile,2001,1998,3,2001,0
It's My Life,2000,1997,3,1980,20
It's Over Now,2001,1998,3,1980,21
Jenny From The Block,2002,1999,3,2002,0
Just Tah Let U Know,1996,1999,3,1995,1
Kiss From A Rose,1995,1998,3,1995,0
Kissin' You,1996,1999,3,1980,16
Lady,1996,1999,3,2014,18
Let Her Cry,1995,1998,3,1995,0
Let Me Be The One,1995,1998,3,1980,15
Let Me Be The One,1995,1998,3,1980,15
Letitgo,1994,1997,3,1994,0
Lifetime,2001,1998,3,1980,21
Living And Living Well,2002,1999,3,2005,3
Locked Up,2004,2001,3,2004,0
Look Into My Eyes,1997,2000,3,1997,0
Love,2001,1998,3,1980,21
Love Don't Love You,1993,1996,3,2006,13
Love Is All Around,1994,1997,3,1980,14
Love Of A Woman,2001,1998,3,2001,0
Loverboy,2001,1998,3,1983,18
Lucky,2000,1997,3,2003,3
Luv U Better,2002,1999,3,2002,0
Mad Season,2001,1998,3,1980,21
Mamacita,2001,1998,3,2008,7
Maybe I Deserve,2001,1998,3,2003,2
Mental Picture,1995,1998,3,1980,15
Misery,1995,1998,3,2004,9
Missing You,2001,1998,3,1985,16
Mrs. Steven Rudy,2001,1998,3,2001,0
Music,2000,1997,3,1997,3
My Everything,2001,1998,3,1980,21
My Front Porch Looking In,2003,2000,3,2003,0
My Neck My Back,2002,1999,3,2012,10
Never Had A Dream Come True,2001,1998,3,1980,21
Never Leave Me Alone,1996,1999,3,1996,0
Nobody Wants To Be Lonely,2001,1998,3,1980,21
Nothing As It Seems,2000,1997,3,1994,6
On A Night Like This,2001,1998,3,2001,0
On Fire,2004,2001,3,2004,0
Only God Knows Why,2000,1997,3,2000,0
Only Wanna Be With You,1995,1998,3,2005,10
Out Of My Head,1999,1996,3,1996,3
Practice What You Preach,1994,1997,3,1980,14
Pretty Girl,1995,1998,3,1980,15
Promise,2001,1998,3,1980,21
Put It On Me,2001,1998,3,2002,1
Rainy Dayz,2002,1999,3,2002,0
Rapture (Tastes So Sweet),2002,1999,3,1980,22
Red Light Special,1995,1998,3,1995,0
Renee,1996,1999,3,1996,0
Riding With Private Malone,2001,1998,3,2001,0
Roll To Me,1995,1998,3,1980,15
Runnin (Dying To Live),2003,2000,3,2005,2
Said I Loved You...But I Lied,1994,1997,3,1980,14
Send Me A Lover,1993,1996,3,1980,13
Sending My Love,1994,1997,3,2007,13
Sentimental,1995,1998,3,1980,15
Sexual (Li Da Di),2000,1997,3,1997,3
Shackles (Praise You),2000,1997,3,2005,5
Shape Of My Heart,2000,1997,3,2000,0
She Couldn't Change Me,2001,1998,3,2001,0
Show Me The Meaning Of Being Lonely,2000,1997,3,2000,0
Simple Kind Of Life,2000,1997,3,1997,3
Sk8er Boi,2002,1999,3,2010,8
Slow And Sexy,1993,1996,3,1989,4
Smile,2000,1997,3,1980,20
So In Love With Two,2001,1998,3,1980,21
Somebody's Crying,1995,1998,3,1980,15
Someone To Love,1995,1998,3,1995,0
Son Of A Gun,2001,1998,3,2001,0
Stand,1993,1996,3,1995,2
Start The Commotion,2001,1998,3,1980,21
Stay The Night,2000,1997,3,1996,4
Stranger In My House,2001,1998,3,2000,1
Streets Of Philadelphia,1994,1997,3,1994,0
Strong Enough,1995,1998,3,1980,15
Stronger,2001,1998,3,1980,21
Stutter,2001,1998,3,2001,0
Superman (It's Not Easy),2001,1998,3,1998,3
Superwoman Pt II,2001,1998,3,2001,0
Survivor,2001,1998,3,2001,0
Take A Bow,1995,1998,3,1994,1
Take It To The Streets,1997,2000,3,1997,0
Take You Out,2001,1998,3,2001,0
Tell Me,1996,1999,3,1983,13
Tell Me,1995,1998,3,1980,15
Ten Rounds With Jose Cuervo,2002,1999,3,2012,10
Tha Crossroads,1996,1999,3,1996,0
Thank You,1995,1998,3,1980,15
That's The Way It Is,2000,1997,3,1980,20
The Christmas Song (Chestnuts Roasting On An Open Fire),2000,2003,3,1994,6
The One,2002,1999,3,2001,1
The Rhythm Of The Night,1995,1998,3,1980,15
The Sweetest Days,1995,1998,3,1994,1
There Is No Arizona,2001,1998,3,2001,0
There It Go! (The Whistle Song),2006,2003,3,2004,2
There She Goes,2001,1998,3,1980,21
They Like It Slow,1997,2000,3,1997,0
This Gift,2000,1997,3,1980,20
This Is Me,2001,1998,3,2013,12
Time And Chance,1993,1996,3,1993,0
Too Bad,2002,1999,3,1980,22
Total Eclipse Of The Heart,1995,1998,3,1981,14
Tough Little Boys,2003,2000,3,2003,0
Tucker's Town,1996,1999,3,1996,0
Turn Off The Light,2001,1998,3,2010,9
U Got It Bad,2001,1998,3,1994,7
U Make Me Wanna,2004,2001,3,2004,0
Until It Sleeps,1996,1999,3,2011,15
Untitled (How Does It Feel),2000,1997,3,1980,20
Walk On The Ocean,1993,1996,3,1992,1
Waterfalls,1995,1998,3,1995,0
We Danced,2000,1997,3,2002,2
What I Really Meant To Say,2001,1998,3,2001,0
What Would You Do?,2001,1998,3,2001,0
When It's Over,2001,1998,3,1980,21
When We Dance,1994,1991,3,1980,14
When You Believe,1999,1996,3,2009,10
Whenever Wherever,2001,1998,3,2001,0
Where Were You (When The World Stopped Turning),2002,1999,3,2001,1
Where Would You Be,2002,1999,3,1980,22
Will You Be There (In The Morning),1994,1997,3,1980,14
With Arms Wide Open,2000,1997,3,1980,20
Wonderful,2004,2001,3,2004,0
You Don't Know How It Feels,1995,1998,3,1980,15
You Gets No Love,2001,1998,3,1980,21
You Remind Me Of Something,1995,1998,3,1980,15
You Shouldn't Kiss Me Like This,2001,1998,3,2004,3
You Used To Love Me,1995,1998,3,1995,0
You Used To Love Me,1995,1998,3,1980,15
You'll See,1995,1998,3,1988,7
7,1993,1997,4,1997,4
' 03 Bonnie & Clyde,2002,1998,4,2006,4
(Lay Your Head On My) Pillow,1994,1998,4,1980,14
100% Pure Love,1994,1998,4,1998,4
7 Days,2002,1998,4,2014,12
A Moment Like This,2002,1998,4,1980,22
A Thousand Miles,2002,1998,4,1980,22
A Whole New World,1993,1997,4,1996,3
A Woman's Worth,2002,1998,4,1991,11
Action,1994,1998,4,2014,20
Addictive,2002,1998,4,1989,13
Ain't It Funny,2002,1998,4,2002,0
Alive,2002,1998,4,1980,22
All I Wanna Do,1994,1998,4,2005,11
All You Wanted,2002,1998,4,2003,1
Always,1994,1998,4,1980,14
Always In My Heart,1994,1998,4,1980,14
Always On Time,2002,1998,4,1980,22
American Child,2002,1998,4,1998,4
And Our Feelings,1994,1998,4,1980,14
Another Night,1994,1998,4,1980,14
Any Time Any Place/And On And On,1994,1998,4,2008,14
Anything,2002,1998,4,2006,4
Anything,1994,1998,4,1980,14
Anytime You Need A Friend,1994,1998,4,2001,7
At Your Best (You Are Love),1994,1998,4,1988,6
Award Tour,1994,1998,4,1996,2
Baby,2002,1998,4,1980,22
Back & Forth,1994,1998,4,2003,9
Be Happy,1994,1998,4,1980,14
Beautiful Mess,2002,1998,4,1980,22
Because Of Love,1994,1998,4,1980,14
Because The Night,1994,1998,4,2009,15
Before I Let You Go,1994,1998,4,1980,14
Better Off Alone,2000,1996,4,1980,20
Bizarre Love Triangle,1994,1998,4,1980,14
Blessed,2002,1998,4,2000,2
Blurry,2002,1998,4,2004,2
Boombastic/In The Summertime,1995,1999,4,1995,0
Booti Call,1994,1998,4,1993,1
Born To Fly,2000,1996,4,1989,11
Bouncin' Back (Bumpin' Me Against the Wall),2002,1998,4,2001,1
Breathe Again,1994,1998,4,1982,12
Bring On The Rain,2002,1998,4,1980,22
Bump N' Grind,1994,1998,4,1980,14
Burn,2001,1997,4,1986,15
Butterflies,2002,1998,4,1981,21
By The Time This Night Is Over,1993,1997,4,1993,0
Call Me,2002,1998,4,2008,6
Can We Talk,1994,1998,4,1989,5
Can't Fight The Moonlight,2002,1998,4,1980,22
Can't Get You Out Of My Head,2002,1998,4,1980,22
Can't Help Falling In Love,1993,1997,4,1980,13
Chain Hang Low,2006,2002,4,2006,0
Choose,1994,1998,4,1994,0
Circle Of Life,1994,1998,4,1994,0
Closer,1994,1998,4,1994,0
Come Inside,1993,1997,4,1980,13
Come To My Window,1994,1998,4,1994,0
Come To My Window,1994,1998,4,1994,0
Completely,1994,1998,4,1980,14
Complicated,2002,1998,4,2002,0
Courtesy Of The Red White And Blue,2002,1998,4,2002,0
Crazy In Love,2003,1999,4,2003,0
Cry,2002,1998,4,1991,11
Cry For You,1994,1998,4,1996,2
Cyclone,2007,2003,4,2007,0
Dance Naked,1994,1998,4,1980,14
Days Go By,2002,1998,4,1980,22
Dear Mama/Old School,1995,1999,4,1995,0
December 1963 (Oh What A Night),1994,1998,4,1994,0
Dilemma,2002,1998,4,2002,0
Dirrty,2002,1998,4,2000,2
Disease,2002,1998,4,1980,22
Do It To It,2006,2002,4,2006,0
Don't Let Me Get Me,2002,1998,4,2002,0
Don't Take The Girl,1994,1998,4,1981,13
Don't Turn Around,1994,1998,4,1980,14
Don't You Forget It,2002,1998,4,1980,22
Dreams,1994,1998,4,1980,14
Dreams,1994,1998,4,1982,12
Ease My Mind,1994,1998,4,1994,0
Endless Love,1994,1998,4,1980,14
Endless Love,1994,1998,4,1980,14
Escape,2002,1998,4,1980,22
Everyday,1994,1998,4,1980,14
Fa All Y'all,1994,1998,4,1994,0
Fall Down,1994,1998,4,1988,6
Feel It Boy,2002,1998,4,1980,22
Feenin',1994,1998,4,1980,14
Foolish,2002,1998,4,1980,22
Found Out About You,1994,1998,4,1980,14
Freak Me,1993,1997,4,2005,12
Full Moon,2002,1998,4,2004,2
Funkdafied,1994,1998,4,1994,0
Game Over (Flip),2004,2000,4,2004,0
Get Money,1996,2000,4,1996,0
Get Over It,1994,1998,4,2011,17
Girl Talk,2002,1998,4,2002,0
Girlfriend,2002,1998,4,1980,22
God Bless The USA,2001,1997,4,1995,6
Good Morning Beautiful,2002,1998,4,1980,22
Goodbye To You,2002,1998,4,1980,22
Got Me Waiting,1994,1998,4,1994,0
Gots Ta Be,2002,1998,4,2002,0
Gotta Get Thru This,2002,1998,4,1980,22
Groove Thang,1994,1998,4,1980,14
Hanging By A Moment,2001,1997,4,1986,15
Happy,2002,1998,4,2002,0
Here Is Gone,2002,1998,4,1980,22
Hero,2002,1998,4,1980,22
Hero,1993,1997,4,1993,0
Hero,2001,1997,4,1980,21
Hey Baby,2002,1998,4,2001,1
Higher Ground,1994,1998,4,1989,5
How Come,2004,2000,4,2004,0
How Do You Like It?,1994,1998,4,1980,14
I Breathe In I Breathe Out,2002,1998,4,1980,22
I Can See Clearly Now,1994,1998,4,1993,1
I Care 4 U,2002,1998,4,1980,22
I Don't Wanna Fight,1993,1997,4,1980,13
I Got ID/Long Road,1995,1999,4,1980,15
I Hope You Dance,2001,1997,4,2000,1
I Keep Looking,2002,1998,4,2002,0
I Miss My Friend,2002,1998,4,2002,0
I Miss You,1994,1998,4,1980,14
I Never Seen A Man Cry (Aka I Seen A Man Die),1994,1998,4,1994,0
I See Your Smile,1993,1997,4,2006,13
I Should Be Sleeping,2002,1998,4,2002,0
I Swear,1994,1998,4,1980,14
I Wanna Be Down,1994,1998,4,1980,14
I Want You,1994,1998,4,1994,0
I'd Give Anything,1994,1998,4,1980,14
I'll Make Love To You,1994,1998,4,1994,0
I'll Remember,1994,1998,4,1980,14
I'm A Believer,2001,1997,4,1980,21
I'm A Hustla,2005,2001,4,2005,0
I'm Every Woman,1993,1997,4,1980,13
I'm Gonna Be Alright,2002,1998,4,1980,22
I'm Gonna Getcha Good!,2002,1998,4,1980,22
I'm In The Mood,1994,1998,4,1987,7
I'm Like A Bird,2001,1997,4,1980,21
I'm Movin' On,2002,1998,4,2002,0
I'm Not Over You,1994,1998,4,1980,14
I'm Ready,1994,1998,4,2006,12
I'm So Into You,1993,1997,4,1980,13
I'm Too Sexy,1992,1996,4,1996,4
If,1993,1997,4,1980,13
If I Could Go!,2002,1998,4,2002,0
If I Had No Loot,1993,1997,4,1980,13
If You Go,1994,1998,4,1980,14
If You Love Me,1995,1999,4,1980,15
In The End,2002,1998,4,1996,6
Into You,2003,1999,4,2003,0
It's All Good,1994,1998,4,1991,3
Jessie,1994,1998,4,2013,19
Joy,1995,1991,4,1980,15
Juicy,1994,1998,4,1994,0
Juicy/Unbelievable,1994,1998,4,1994,0
Just A Friend 2002,2002,1998,4,2002,0
Just Like A Pill,2002,1998,4,2002,0
Let It Snow,1994,1998,4,2007,13
Life (Everybody Needs Somebody To Love),1994,1998,4,1980,14
Linger,1994,1998,4,1988,6
Living In Danger,1994,1998,4,1980,14
Loco,2004,2000,4,2004,0
Love At First Sight,2002,1998,4,1980,22
Love Is,1990,1994,4,1980,10
Love Is,1993,1997,4,1995,2
Love Is On The Way,1992,1996,4,1992,0
Love On My Mind,1994,1998,4,1980,14
Love Sneakin' Up On You,1994,1998,4,1994,0
Lucky One,1994,1998,4,1994,0
Makin' Good Love,2002,1998,4,2012,10
Man To Man,2003,1999,4,2013,10
Mary Jane's Last Dance,1994,1998,4,1994,0
Milkshake,2003,1999,4,2000,3
Misled,1994,1998,4,1994,0
Miss You In A Heartbeat,1994,1998,4,1980,14
Mmm Mmm Mmm Mmm,1994,1998,4,1994,0
More Than That,2001,1997,4,1980,21
Mother,1994,1998,4,1980,14
Mouth,1996,2000,4,1994,2
Moving On Up,1994,1998,4,1980,14
My Heart Belongs To You,1991,1995,4,1980,11
My List,2002,1998,4,2002,0
My Sacrifice,2002,1998,4,2001,1
My Town,2002,1998,4,1980,22
Never Keeping Secrets,1994,1998,4,1993,1
No More Drama,2002,1998,4,1980,22
No Problem,2004,2000,4,2006,2
No Shoes No Shirt No Problems,2003,1999,4,2010,7
None Of Your Business,1994,1998,4,1994,0
Not A Day Goes By,2002,1998,4,1980,22
Nothing In This World,2002,1998,4,1991,11
Objects In The Rear View Mirror May Appear Closer Than,1994,1998,4,1994,0
On Bended Knee,1994,1998,4,1999,5
One Last Breath,2002,1998,4,1980,22
One Last Cry,1993,1997,4,1980,13
One Woman,1993,1997,4,1980,13
Ooh Child,1993,1997,4,1992,1
Ordinary Day,2002,1998,4,2002,0
Outta Control (Remix),2005,2001,4,2005,0
Pink Cashmere,1993,1997,4,2005,12
Pop,2001,1997,4,1980,21
Pop Lock & Drop It,2007,2003,4,2007,0
Power Of Love,1991,1995,4,1991,0
Rain,1993,1997,4,1986,7
Raining On Sunday,2003,1999,4,1982,21
Reason To Believe,1993,1997,4,1993,0
Red Rag Top,2002,1998,4,2004,2
Return To Innocence,1994,1998,4,1980,14
Rock And Roll Dreams Come Through,1994,1998,4,1994,0
Run To You,1993,1997,4,1980,13
Runaway Train,1993,1997,4,1993,0
Runaway Train,1993,1997,4,1993,0
Running Away,2002,1998,4,1980,22
Salt Shaker,2004,2000,4,2003,1
Scream/Childhood,1995,1991,4,1980,15
Secret,1994,1998,4,1980,14
Shake Ya Tailfeather,2003,1999,4,2003,0
Shame,1994,1998,4,1994,0
She Hates Me,2002,1998,4,1980,22
She'll Leave You With A Smile,2002,1998,4,1980,22
Shorty Wanna Ride,2004,2000,4,2004,0
Shoulder Lean,2006,2002,4,2006,0
Show Me Love,1993,1997,4,1995,2
Show Me Love,1993,1997,4,1995,2
Sleeping In My Car,1994,1998,4,1980,14
So Many Tears,1995,1991,4,1980,15
So Much In Love,1994,1998,4,1998,4
So Seductive,2005,2001,4,2008,3
So Yesterday,2003,1999,4,1980,23
Soak Up The Sun,2002,1998,4,2002,0
Somebody Like You,2002,1998,4,1994,8
Someone To Love You,2002,1998,4,1980,22
Sorry 2004,2004,2000,4,2004,0
Stay,1994,1998,4,1986,8
Stay (I Missed You),1994,1998,4,2014,20
Stingy,2002,1998,4,1980,22
Stroke You Up,1994,1998,4,1980,14
Stuntin' Like My Daddy,2006,2002,4,2006,0
Sweet Potatoe Pie,1994,1998,4,1994,0
That's The Way Love Goes,1993,1997,4,1993,0
That's When I Love You,2002,1998,4,1980,22
The Baby,2003,1999,4,1984,19
The Cowboy In Me,2002,1998,4,1985,17
The Crying Game,1993,1997,4,1980,13
The Game Of Love,2002,1998,4,1980,22
The Impossible,2002,1998,4,2002,0
The Long Goodbye,2002,1998,4,1980,22
The Middle,2002,1998,4,1980,22
The Most Beautiful Girl In The World,1994,1998,4,1980,14
The Place Where You Belong,1994,1998,4,1980,14
The Power Of Love,1994,1998,4,1987,7
The Sign,1994,1998,4,1980,14
The Way She Loves Me,1994,1998,4,1980,14
The World I Know,1996,2000,4,1996,0
The World's Greatest,2002,1998,4,2002,0
These Days,2002,1998,4,2002,0
This Is For The Lover In You,1996,2000,4,1996,0
This Is For The Lover In You,1996,2000,4,1996,0
Throw Some D's,2007,2003,4,2005,2
Throw Your Set In The Air,1995,1999,4,1992,3
Too Many Walls,1991,1995,4,1995,4
Travelin' Soldier,2003,1999,4,2003,0
Turn The Beat Around,1994,1998,4,1991,3
U Already Know,2005,2001,4,1981,24
U Don't Have To Call,2002,1998,4,2002,0
U Remind Me,2001,1997,4,1996,5
U Send Me Swingin',1994,1998,4,1980,14
Unbroken,2002,1998,4,1980,22
Underneath It All,2002,1998,4,2002,0
Underneath Your Clothes,2002,1998,4,2010,8
Understanding,1994,1998,4,1993,1
Wait (The Whisper Song),2005,2001,4,2005,0
Walking Away,2002,1998,4,2002,0
Watch Me,2015,2011,4,2015,0
Wave On Wave,2003,1999,4,2003,0
What About Us?,2002,1998,4,1998,4
What Do You Say To That,1999,1995,4,1999,0
What If She's An Angel,2002,1998,4,1980,22
What Was I Thinkin',2003,1999,4,2003,0
What's Luv?,2002,1998,4,2002,0
What's The Frequency Kenneth?,1994,1998,4,1994,0
When Can I See You,1994,1998,4,1980,14
When I Fall In Love,1993,1997,4,1980,13
When She Cries,1993,1997,4,1992,1
Where Are You Going,2002,1998,4,1980,22
Where the Stars & Stripes and the Eagle Fly,2001,1997,4,1980,21
Where'd You Go,2006,2002,4,2006,0
Wherever You Will Go,2002,1998,4,1980,22
Whiskey Lullaby,2004,2000,4,2004,0
Why Can't I,2003,1999,4,2001,2
Willing To Forgive,1994,1998,4,2006,12
Without You/Never Forget You,1994,1998,4,1980,14
Wrapped Around,2002,1998,4,2003,1
You And Me,2005,2001,4,1980,25
You Can't Take The Honky Tonk Out Of The Girl,2004,2000,4,2003,1
You Know You're Right,2002,1998,4,1989,13
You Mean The World To Me,1994,1998,4,1980,14
Your Body's Callin',1994,1998,4,2000,6
Youth Of The Nation,2002,1998,4,2002,0
dontchange,2002,1998,4,1980,22
halfcrazy,2002,1998,4,1980,22
1985,2004,1999,5,2002,2
(Everything I Do) I Do It For You,1991,1996,5,1980,11
(I Know I Got) Skillz,1993,1998,5,2009,16
(Meet) The Flintstones,1994,1999,5,2010,16
(There's Gotta Be) More To Life,2003,1998,5,1980,23
1st Of Tha Month,1995,2000,5,2000,5
21 Questions,2003,1998,5,1996,7
24/7,1999,2004,5,1980,19
4 Ever,2003,1998,5,1995,8
99 Problems,2004,1999,5,2006,2
A Bad Goodbye,1993,1998,5,1980,13
A Little Less Conversation,2002,1997,5,1982,20
A New Day Has Come,2002,1997,5,1980,22
ABC-123,1993,1998,5,1991,2
Act A Fool,2003,1998,5,2004,1
Addicted,2003,1998,5,1980,23
Again,1993,1998,5,1980,13
Air Force Ones,2003,1998,5,2003,0
All About Soul,1993,1998,5,1980,13
All I Have,2003,1998,5,2007,4
All That She Wants,1993,1998,5,1980,13
All The Things She Said,2003,1998,5,1980,23
Alright,1993,1998,5,1993,0
Alright,1993,1998,5,1993,0
American Life,2003,1998,5,2008,5
Angel,2003,1998,5,1980,23
Angel,1993,1998,5,1980,13
Anniversary,1993,1998,5,2004,11
Another Sad Love Song,1993,1998,5,1980,13
Are You Happy Now?,2003,1998,5,1980,23
Baby Boy,2003,1998,5,1990,13
Baby I'm Yours,1993,1998,5,1980,13
Back Seat Of My Jeep/Pink Cookies In A Plastic Bag,1993,1998,5,2012,19
Back To The Hotel,1993,1998,5,1996,3
Bad Boy This Bad Boy That,2003,1998,5,2005,2
Bad Boys,1993,1998,5,2007,14
Bad Girl,1993,1998,5,1980,13
Balla Baby,2004,1999,5,2003,1
Beautiful,2003,1998,5,1980,23
Beautiful,2003,1998,5,2001,2
Beautiful Girl,1993,1998,5,1980,13
Bed Of Roses,1993,1998,5,1996,3
Beer For My Horses,2003,1998,5,1998,5
Better Than You,1993,1998,5,1980,13
Big Star,2003,1998,5,1998,5
Bigger Than My Body,2003,1998,5,1980,23
Blowin' Me Up (With Her Love),2003,1998,5,1980,23
Both Sides Of The Story,1993,1998,5,2000,7
Break It Down Again,1993,1998,5,1993,0
Breathe,2003,1998,5,1980,23
Bright Lights,2003,1998,5,1991,12
Bring Me To Life,2003,1998,5,1980,23
Broken Arrow,1992,1997,5,1999,7
Brokenheartsville,2003,1998,5,2003,0
Buddy X,1993,1998,5,1993,0
Calling All Angels,2003,1998,5,2009,6
Can't Get Enough Of Your Love,1993,1998,5,1980,13
Can't Hold Us Down,2003,1998,5,2001,2
Can't Let You Go,2003,1998,5,2003,0
Cat's In The Cradle,1993,1998,5,1995,2
Chattahoochee,1993,1998,5,2008,15
Clocks,2003,1998,5,1986,17
Come As You Are,1992,1997,5,1992,0
Come Baby Come,1993,1998,5,1993,0
Come Clean,2004,1999,5,2013,9
Come Over,2003,1998,5,1987,16
Come Undone,1993,1998,5,1980,13
Comforter,1993,1998,5,1993,0
Concrete Angel,2003,1998,5,2013,10
Confessions Part II,2004,1999,5,2004,0
Connected,1993,1998,5,1990,3
Connected,1993,1998,5,1990,3
Cowboys Like Us,2003,1998,5,1980,23
Creep,1993,1998,5,1993,0
Cry Me A River,2003,1998,5,1980,23
Cry No More,1993,1998,5,1980,13
Dance With My Father,2003,1998,5,1980,23
Dedicated,1993,1998,5,1993,0
Did My Time,2003,1998,5,1993,10
Do You Believe In Us,1992,1997,5,1992,0
Do You See,1995,2000,5,1994,1
Don't Be Afraid,1992,1997,5,1980,12
Don't Know Why,2003,1998,5,2005,2
Don't Say Goodbye,2002,1997,5,2002,0
Don't Walk Away,1993,1998,5,1980,13
Down With The King,1993,1998,5,1993,0
Dreamlover,1993,1998,5,1993,0
Dunkie Butt (Please Please Please),1994,1999,5,1994,0
Everybody Hurts,1993,1998,5,1980,13
Everybody's Free (To Feel Good),1992,1997,5,1980,12
Everything's Gonna Be Alright,1993,1998,5,1993,0
F**k It (I Don't Want You Back),2004,1999,5,2004,0
Faithful,1993,1998,5,1980,13
Fall Into Me,2003,1998,5,1980,23
Family Portrait,2003,1998,5,2002,1
Fighter,2003,1998,5,2003,0
Flex,1993,1998,5,1992,1
Gangsta,1993,1998,5,1990,3
Gangsta's Paradise,1995,1990,5,1980,15
Get Away,1993,1998,5,1993,0
Get It Up,1993,1998,5,1993,0
Get Like Me,2008,2003,5,2008,0
Gin And Juice,1994,1999,5,1994,0
Girl U For Me/Lose Control,1993,1998,5,1980,13
Girl I've Been Hurt,1993,1998,5,1980,13
Girlfriend/Boyfriend,1999,2004,5,1980,19
Girls And Boys,2003,1998,5,2011,8
Give It Away,2006,2001,5,1981,25
Give It Up Turn It Loose,1993,1998,5,1992,1
God Bless The U.S.A.,2003,1998,5,1982,21
Grind With Me,2005,2000,5,2005,0
Harder To Breathe,2003,1998,5,2003,0
Hat 2 Da Back,1993,1998,5,1993,0
Have I Told You Lately,1993,1998,5,1981,12
Have You Forgotten?,2003,1998,5,1982,21
Headsprung,2004,1999,5,2004,0
Headstrong,2003,1998,5,1982,21
Heaven,2004,1999,5,2004,0
Hell Yeah,2003,1998,5,2003,0
Hella Good,2002,1997,5,2002,0
Help Pour Out The Rain (Lacey's Song),2003,1998,5,2003,0
Here Comes The Hotstepper,1994,1999,5,1994,0
Here We Go Again!,1993,1998,5,2008,15
Hey Jealousy,1993,1998,5,1980,13
Hopelessly,1993,1998,5,1980,13
How You Gonna Act Like That,2003,1998,5,2003,0
Human Wheels,1993,1998,5,1993,0
I Am Mine,2002,1997,5,2013,11
I Drove All Night,2003,1998,5,1980,23
I Get Around,1993,1998,5,1993,0
I Got A Feelin',2004,1999,5,1980,24
I Hate U,1995,2000,5,2003,8
I Have Nothing,1993,1998,5,1980,13
I Just Wanna Be Mad,2003,1998,5,2003,0
I Know What You Want,2003,1998,5,1980,23
I Know You See It,2006,2001,5,2006,0
I Love You,2002,1997,5,1980,22
I Should Be...,2003,1998,5,2009,6
I Will Be Here For You,1992,1997,5,1980,12
I'd Do Anything For Love (But I Won't Do That),1993,1998,5,1993,0
I'll Never Get Over You (Getting Over Me),1993,1998,5,1993,0
I'll Take You There,1994,1999,5,1980,14
I'm Free,1993,1998,5,1980,13
I'm Glad,2003,1998,5,2002,1
I'm Outstanding,1994,1999,5,1994,0
I'm With You,2003,1998,5,2002,1
If You're Not The One,2003,1998,5,2003,0
In Love Wit Chu,2003,1998,5,2006,3
In These Arms,1993,1998,5,1998,5
In Those Jeans,2003,1998,5,2003,0
It's Five O'Clock Somewhere,2003,1998,5,2003,0
It's Gonna Be A Lovely Day,1993,1998,5,1984,9
It's My Life,2004,1999,5,1980,24
Justified And Ancient,1992,1997,5,1980,12
Justified And Ancient,1992,1997,5,2005,13
Keep On Keepin' On,1996,1991,5,1980,16
Keep Ya Head Up,1994,1999,5,1993,1
Knockin' Da Boots,1993,1998,5,1993,0
L.O.V.E.,2006,2001,5,1980,26
Landslide,2003,1998,5,2002,1
Lies,1991,1996,5,1980,11
Little Bird,1993,1998,5,1988,5
Loungin,1996,2001,5,1996,0
Love Can Move Mountains,1993,1998,5,1980,13
Love Me All Up,1992,1997,5,1991,1
Love No Limit,1993,1998,5,1980,13
Love Of My Life (An Ode To Hip Hop),2003,1998,5,1980,23
Love Shoulda Brought You Home,1993,1998,5,1992,1
Love U More,1993,1998,5,1983,10
Love You Out Loud,2003,1998,5,1992,11
Mama I'm Coming Home,1992,1997,5,1980,12
Maria,1992,1997,5,1985,7
Mayberry,2004,1999,5,2005,1
Miss You,2003,1998,5,2002,1
More & More,2003,1998,5,1980,23
More And More,1993,1998,5,1980,13
Move Ya Body,2004,1999,5,1980,24
Mr. Vain,1994,1999,5,1995,1
My Drink N' My 2 Step,2007,2002,5,2007,0
My Happy Ending,2004,1999,5,2004,0
My Heart Is Lost To You,2002,1997,5,1981,21
My Love Is Like... Wo,2003,1998,5,1994,9
Never A Time,1993,1998,5,1980,13
Never Leave You - Uh Ooh Uh Oooh!,2003,1998,5,1980,23
Never Lie,1994,1999,5,1994,0
Never Should've Let You Go,1993,1998,5,1980,13
No Letting Go,2003,1998,5,2003,0
No Mistakes,1993,1998,5,1980,13
No Rain,1993,1998,5,2014,21
Not The Only One,1992,1997,5,1992,0
Not Today,2004,1999,5,2002,2
Nothin' My Love Can't Fix,1993,1998,5,1993,0
Nuttin' But Love,1994,1999,5,1994,0
Nuttin' But Love,1994,1999,5,1994,0
Ordinary People,2005,2000,5,1980,25
Ordinary World,1993,1998,5,1993,0
Perfect,2004,1999,5,2002,2
Picture,2003,1998,5,2002,1
Please Forgive Me,1993,1998,5,1980,13
Poppin' My Collar,2006,2001,5,2006,0
Pretty Vegas,2005,2000,5,2013,8
Pullin' Me Back,2006,2001,5,1996,10
Put That Woman First,2003,1998,5,2009,6
Quality Time,1993,1998,5,1980,13
Real Good Man,2003,1998,5,1988,15
Red Dirt Road,2003,1998,5,2003,0
Regret,1993,1998,5,1980,13
Remedy (I Won't Worry),2003,1998,5,2003,0
Rhythm Is A Dancer,1993,1998,5,1992,1
Rhythm Of My Heart,1991,1996,5,1991,0
Right Here (Human Nature)/Downtown,1993,1998,5,1993,0
Right Now,1992,1997,5,1992,0
Rock Wit U (Awww Baby),2003,1998,5,2003,0
Rock Your Body,2003,1998,5,1980,23
Romeo,1993,1998,5,2011,18
Romeo & Juliet,1992,1997,5,1992,0
Romeo & Juliet,1992,1997,5,1992,0
Satisfaction,2003,1998,5,2002,1
Save Up All Your Tears,1992,1997,5,1980,12
Saving Forever For You,1993,1998,5,1980,13
Say Yes,2003,1998,5,1980,23
Scandalous,2004,1999,5,1993,11
Seasons Of Love,2005,2000,5,2002,3
Send Me An Angel,1992,1997,5,1980,12
Senorita,2003,1998,5,1980,23
Sex Me,1993,1998,5,2003,10
She's My Kind Of Rain,2003,1998,5,2003,0
Shine,1994,1999,5,1980,14
Show Me The Way,1991,1996,5,2012,21
Silent Prayer,1992,1997,5,1980,12
Simple Life,1993,1998,5,1995,2
Slow And Easy,1994,1999,5,1999,5
Snap Yo Fingers,2006,2001,5,2006,0
So Alone,1993,1998,5,2006,13
So Far Away,2003,1998,5,1990,13
So Gone,2003,1998,5,1995,8
Somebody To Love,1993,1998,5,1993,0
Somebody To Love,1993,1998,5,1993,0
Someone To Call My Lover,2001,1996,5,1996,5
Something,2003,1998,5,1980,23
Something In Your Eyes,1993,1998,5,1993,0
Something In Your Eyes,1993,1998,5,1993,0
Something's Always Wrong,1994,1999,5,1980,14
Something's Goin' On,1993,1998,5,1993,0
Something's Goin' On,1993,1998,5,1993,0
Sometimes Love Just Ain't Enough,1992,1997,5,1980,12
Somewhere I Belong,2003,1998,5,1980,23
Soul Survivor,2005,2000,5,2005,0
Speed,2003,1998,5,2011,8
Stand Up,2003,1998,5,2003,0
Stand Up (Kick Love Into Motion),1993,1998,5,1980,13
Stars,1992,1997,5,1988,4
Stay Gone,2003,1998,5,1980,23
Steelo,1996,1991,5,1980,16
Step In The Name Of Love,2003,1998,5,1980,23
Strange Currencies,1995,2000,5,1995,0
Sunshine,2004,1999,5,2004,0
Superman,2003,1998,5,2003,0
Sweat (A La La La La Long),1993,1998,5,1993,0
Sweet Thing,1993,1998,5,1980,13
T.L.C.,1992,1997,5,1992,0
Tell Me What You Dream,1993,1998,5,1980,13
That's That S***,2006,2001,5,2006,0
That's What Love Can Do,1993,1998,5,1980,13
That?s What Love Can Do,1993,1998,5,1980,13
The Anthem,2003,1998,5,2003,0
The Boys Of Summer,2003,1998,5,2015,12
The Last Song,1992,1997,5,1983,9
The One,1992,1997,5,1992,0
The Right Kind Of Love,1993,1998,5,1980,13
The River Of Dreams,1993,1998,5,1982,11
The Voice Within,2004,1999,5,1980,24
There Goes My Life,2003,1998,5,1999,4
They Don't Care About Us,1996,1991,5,1980,16
Thinkin' Problem,1994,1999,5,1980,14
This D.J.,1994,1999,5,1994,0
This Is How We Do It,1995,2000,5,1995,0
This Is The Night,2003,1998,5,1980,23
This One's For The Girls,2003,1998,5,2009,6
This Used To Be My Playground,1992,1997,5,1980,12
Three Wooden Crosses,2003,1998,5,2010,7
Tipsy,2004,1999,5,2004,0
Too Much Passion,1992,1997,5,1992,0
Turn Me On,2004,1999,5,2004,0
Two Steps Behind,1993,1998,5,1980,13
U.N.I.T.Y.,1994,1999,5,1993,1
Unwell,2003,1998,5,1980,23
Walked Outta Heaven,2003,1998,5,1995,8
Wasting My Time,2002,1997,5,1980,22
We Fly High,2007,2002,5,2006,1
Weak,1993,1998,5,1993,0
What Becomes Of The Brokenhearted,1992,1997,5,1980,12
What Is Love,1993,1998,5,1980,13
What Would You Do?,2003,1998,5,2004,1
What's Up,1993,1998,5,1993,0
Whatta Man,1994,1999,5,1994,0
Whatta Man,1994,1999,5,1994,0
When Boy Meets Girl,1996,2001,5,2011,15
When I Look Into Your Eyes,1992,1997,5,1980,12
When I'm Gone,2003,1998,5,1984,19
Where Have All The Cowboys Gone?,1997,2002,5,2015,18
Where You Goin' Now,1992,1997,5,1980,12
Whiskey Girl,2004,1999,5,2006,2
Who Will Save Your Soul,1996,1991,5,1980,16
Who's Gonna Ride Your Wild Horses,1992,1997,5,1980,12
Why Don't You & I,2003,1998,5,2001,2
Wild World,1993,1998,5,1980,13
Window Shopper,2005,2000,5,2005,0
Wishing On A Star,1992,1997,5,1991,1
With You,2004,1999,5,1999,5
You Think You Know Her,1992,1997,5,1992,0
You Want This/70's Love Groove,1994,1999,5,1999,5
Your Body Is A Wonderland,2003,1998,5,2002,1
1 2 Step,2005,1999,6,2005,0
100 Years,2004,1998,6,1999,5
2 Legit 2 Quit,1992,1998,6,2003,11
8th World Wonder,2004,1998,6,1980,24
A Deeper Love/Pride (In The Name Of Love),1992,1998,6,1980,12
Accidentally In Love,2004,1998,6,1986,18
Achy Breaky Heart,1992,1998,6,2006,14
Addams Groove,1992,1998,6,1992,0
Again Tonight,1992,1998,6,1980,12
Ain't 2 Proud 2 Beg,1992,1998,6,1995,3
Alcohol,2005,1999,6,1980,25
All 4 Love,1992,1998,6,1980,12
All Falls Down,2004,1998,6,2001,3
All I Want,1992,1998,6,1984,8
Always The Last To Know,1992,1998,6,1980,12
Am I The Same Girl,1992,1998,6,1980,12
American Soldier,2004,1998,6,1983,21
Angel Baby,1992,1998,6,1994,2
Anything At All,1992,1998,6,1980,12
Are You Gonna Be My Girl,2004,1998,6,1980,24
Baby Hold On To Me,1992,1998,6,1997,5
Baby It's You,2004,1998,6,2004,0
Baby-Baby-Baby,1992,1998,6,1991,1
Back In The Day,1994,2000,6,1997,3
Back Then,2005,1999,6,2008,3
Back When,2004,1998,6,1993,11
Barrel Of A Gun,1997,2003,6,1980,17
Beauty And The Beast,1992,1998,6,2006,14
Big Chips,2004,1998,6,2006,2
Boot Scootin' Boogie,1992,1998,6,2008,16
Bossy,2006,2000,6,2006,0
Breakaway,2004,1998,6,2004,0
Breakin' My Heart (Pretty Brown Eyes),1992,1998,6,1992,0
Breaking The Habit,2004,1998,6,2004,0
Breathe Stretch Shake,2004,1998,6,2004,0
Broken,2004,1998,6,1991,13
Burn,2004,1998,6,2004,0
Can't Cry Hard Enough,1992,1998,6,1980,12
Can't Let Go,1992,1998,6,1980,12
Can't You See,1995,2001,6,1995,0
Cannonball,1994,2000,6,2005,11
Chains Around My Heart,1992,1998,6,1992,0
Charlene,2004,1998,6,2004,0
Children,1996,1990,6,1980,16
Church Of Your Heart,1992,1998,6,1980,12
Closer To Me,1992,1998,6,1985,7
Come & Talk To Me,1992,1998,6,1980,12
Come Again,1991,1997,6,1997,6
Constant Craving,1992,1998,6,2006,14
Crossover,1992,1998,6,1992,0
Damn I Wish I Was Your Lover,1992,1998,6,1983,9
Dare You To Move,2004,1998,6,1980,24
Days Go By,2004,1998,6,2004,0
Deeper And Deeper,1993,1999,6,1980,13
Desperately,2004,1998,6,1980,24
Diamonds And Pearls,1992,1998,6,1980,12
Diary,2004,1998,6,2004,0
Dip It Low,2004,1998,6,2004,0
Dip it Low,2004,1998,6,2004,0
Divine Thing,1992,1998,6,1986,6
Do It To Me,1992,1998,6,1992,0
Does She Love That Man?,1991,1997,6,1990,1
Don't Let The Sun Go Down On Me,1992,1998,6,2006,14
Don't Take Your Love Away,2004,1998,6,2004,0
Don't Tell Me,2004,1998,6,1980,24
Don't Treat Me Bad,1991,1997,6,1980,11
Dream Lover,1991,1997,6,1989,2
Dreams,2004,1998,6,1980,24
Drift Away,2003,1997,6,1980,23
Dude,2004,1998,6,2004,0
Emotional Rollercoaster,2003,1997,6,1993,10
End Of The Road,1992,1998,6,1992,0
Erotica,1992,1998,6,1992,0
Even Better Than The Real Thing,1992,1998,6,1980,12
Everything About You,1992,1998,6,1980,12
Everything Changes,1992,1998,6,1980,12
Everytime,2004,1998,6,1980,24
Faint,2003,1997,6,1980,23
Fallen,2004,1998,6,1997,7
Feelin' Way Too Damn Good,2004,1998,6,1985,19
Finally,1992,1998,6,1989,3
Firecracker,2007,2001,6,1980,27
Flying Without Wings,2003,1997,6,2003,0
Forever Love,1992,1998,6,1980,12
Free Your Mind,1992,1998,6,1992,0
Friday I'm In Love,1992,1998,6,1992,0
Gentle,1991,1997,6,1980,11
Getting' Some,2006,2000,6,2006,0
Girl Tonite,2005,1999,6,1987,18
Girls Lie Too,2004,1998,6,2004,0
Give It Up,1994,2000,6,1994,0
Give It Up,1992,1998,6,1980,12
Give Me One Reason,1996,1990,6,1980,16
Give Me That,2005,1999,6,1997,8
Give U My Heart,1992,1998,6,1980,12
Giving Him Something He Can Feel,1992,1998,6,1980,12
Good Enough,1992,1998,6,1983,9
Good For Me,1992,1998,6,1980,12
Hang In Long Enough,1991,1997,6,1993,2
Happy People,2004,1998,6,2004,0
Hate It Or Love It,2005,1999,6,2005,0
Have You Ever Needed Someone So Bad,1992,1998,6,1980,12
Hazard,1992,1998,6,1992,0
Heard 'Em Say,2005,1999,6,2005,0
Hearts Don't Think (They Feel),1992,1998,6,1983,9
Heat Of The Moment,1991,1997,6,2003,12
Helena (So Long & Goodnight),2005,1999,6,2005,0
Here For The Party,2004,1998,6,2004,0
Here We Go,2005,1999,6,2001,4
Here Without You,2003,1997,6,1980,23
Hey D.J.,1994,2000,6,1994,0
Hey D.J.,1994,2000,6,1994,0
Hey Mr. D.J.,1993,1999,6,2004,11
High,1992,1998,6,1992,0
Higher Than Hope,1991,1997,6,1996,5
Hold On My Heart,1992,1998,6,1980,12
Home Sweet Home,1992,1998,6,1980,12
Honey Love,1992,1998,6,2005,13
Hope,2005,1999,6,2005,0
Hotel,2004,1998,6,2004,0
How About That,1992,1998,6,1989,3
How Am I Doin',2004,1998,6,1980,24
How Do You Talk To An Angel,1992,1998,6,1980,12
How To Dance,1991,1997,6,1991,0
Human Touch/Better Days,1992,1998,6,1992,0
Humpin' Around,1992,1998,6,2005,13
I Believe,2003,1997,6,1980,23
I Can't Make You Love Me,1992,1998,6,1992,0
I Go Back,2004,1998,6,2004,0
I Hate Everything,2004,1998,6,2004,0
I Love You Period,1993,1999,6,1987,6
I Love Your Smile,1992,1998,6,1991,1
I Melt,2003,1997,6,1980,23
I Wanna Be Your Girl,1992,1998,6,1987,5
I Wanna Do It All,2004,1998,6,2004,0
I Wanna Love You,1992,1998,6,1980,12
I Want To Live,2004,1998,6,2004,0
I Will Always Love You,1992,1998,6,1980,12
I Will Remember You,1992,1998,6,1984,8
I Wish The Phone Would Ring,1992,1998,6,1990,2
I Wonder Why,1991,1997,6,1980,11
I'd Die Without You,1992,1998,6,1992,0
I'll Be By Your Side,1991,1997,6,1980,11
I'll Be There,1992,1998,6,1992,0
I'll Be There For You/You're All I Need To Get By,1995,2001,6,1995,0
I'll Be There For You/You're All I Need To Get By,1995,2001,6,1995,0
I'll Get By,1992,1998,6,1980,12
I'll Never Let You Go,1991,1997,6,1988,3
I'm N Luv (Wit A Stripper),2006,2000,6,2006,0
I'm Still In Love With You,2004,1998,6,2004,0
I'm The One You Need,1992,1998,6,1980,12
I've Been Waiting For You,1991,1997,6,1980,11
I've Got A Lot To Learn About Love,1992,1998,6,1980,12
Icky Thump,2007,2001,6,2007,0
If I Ever Fall In Love,1992,1998,6,2008,16
If You Asked Me To,1992,1998,6,1980,12
If You Ever Stop Loving Me,2004,1998,6,2004,0
If You Go Away,1992,1998,6,1980,12
In My Daughter's Eyes,2004,1998,6,1980,24
In My Dreams,1992,1998,6,2013,21
Informer,1993,1999,6,1993,0
Innocent Child,1992,1998,6,1980,12
Invisible,2004,1998,6,2004,0
Is It Good To You,1992,1998,6,1991,1
It Ain't Over 'Til It's Over,1991,1997,6,1980,11
It Was A Good Day,1993,1999,6,1993,0
It's Goin' Down,2006,2000,6,2006,0
Jesus He Knows Me,1992,1998,6,1992,0
Jump Around,1992,1998,6,1992,0
Just A Lil Bit,2005,1999,6,2005,0
Just A Little While,2004,1998,6,1996,8
Just Another Day,1992,1998,6,1980,12
Just For Tonight,1992,1998,6,1980,12
Just Take My Heart,1992,1998,6,1992,0
Keep Coming Back,1991,1997,6,1980,11
Keep It Comin',1992,1998,6,1980,12
Keep On Walkin',1992,1998,6,1980,12
Keep The Faith,1992,1998,6,1990,2
Knocks Me Off My Feet,1997,1991,6,1980,17
Layla,1992,1998,6,1983,9
Leave (Get Out),2004,1998,6,2004,0
Let Me Go,2005,1999,6,1980,25
Let's Be Us Again,2004,1998,6,1980,24
Let's Get Rocked,1992,1998,6,1992,0
Letters From Home,2004,1998,6,1990,14
Life Is A Highway,1992,1998,6,1980,12
Lift Me Up,1992,1998,6,1980,12
Lights And Sounds,2006,2000,6,1993,13
Like A Stone,2003,1997,6,2003,0
Lip Gloss,2007,2001,6,2007,0
Little Miss Can't Be Wrong,1992,1998,6,2012,20
Little Moments,2004,1998,6,2006,2
Live And Learn,1992,1998,6,1985,7
Live And Let Die,1992,1998,6,1980,12
Living In Fast Forward,2006,2000,6,2004,2
London Bridge,2006,2000,6,2008,2
Lose My Breath,2004,1998,6,2004,0
Lot Of Leavin' Left To Do,2005,1999,6,2005,0
Love Makes Things Happen,1991,1997,6,1991,0
Love Me,1992,1998,6,1980,12
Make It Happen,1992,1998,6,1980,12
Make Love Like A Man,1992,1998,6,1992,0
MakeDamnSure,2006,2000,6,1980,26
Me Myself And I,2004,1998,6,1980,24
Mercy Mercy Me (The Ecology)/I Want You,1991,1997,6,1991,0
Miles Away,1991,1997,6,1980,11
Mind Playing Tricks On Me,1992,1998,6,1991,1
Missing You Now,1992,1998,6,1998,6
Mockingbird,2005,1999,6,2005,0
Money Don't Matter 2 Night,1992,1998,6,2005,13
Moneytalks,1991,1997,6,1988,3
More Than Ever,1991,1997,6,2000,9
More Than Words,1991,1997,6,1980,11
Move Any Mountain,1992,1998,6,1992,0
My Baby,2004,1998,6,2004,0
My Boo,2004,1998,6,1980,24
My Immortal,2004,1998,6,2004,0
My Kinda Party,2010,2004,6,2010,0
My Lovin' (You're Never Gonna Get It),1992,1998,6,1992,0
My Lovin' (You're Never Gonna Get It),1992,1998,6,1989,3
My Place,2004,1998,6,2004,0
Nasty Girl,2006,2000,6,2006,0
Naughty Girl,2004,1998,6,1980,24
Never Gonna Let You Down,1991,1997,6,1991,0
No Matter What,1991,1997,6,1980,11
No Ordinary Love,1993,1999,6,1980,13
No Son Of Mine,1992,1998,6,1991,1
Not Enough Time,1992,1998,6,1992,0
Nothing Broken But My Heart,1992,1998,6,1980,12
Nothing Else Matters,1992,1998,6,1980,12
Nothing On But The Radio,2004,1998,6,1980,24
November Rain,1992,1998,6,1981,11
Nu Nu,1992,1998,6,1992,0
Numb,2004,1998,6,2003,1
Ocean Avenue,2004,1998,6,1980,24
On The Way Down,2004,1998,6,2010,6
On The Way Up,1991,1997,6,1997,6
One,1992,1998,6,1992,0
One Call Away,2004,1998,6,2004,0
One More Try,1991,1997,6,1980,11
One More Try,1991,1997,6,1980,11
One Thing,2004,1998,6,2004,0
Over And Over,2004,1998,6,2004,0
Paint Me A Birmingham,2004,1998,6,1992,12
People Everyday,1992,1998,6,1992,0
Perfect,2003,1997,6,2003,0
Place In This World,1991,1997,6,2006,15
Play,2005,1999,6,2005,0
Please Don't Go,1992,1998,6,2013,21
Pop Champagne,2009,2003,6,2008,1
Pour It Up,2013,2007,6,2013,0
Promise,2006,2000,6,1980,26
Rain On Me,2003,1997,6,2003,0
Read Your Mind,2004,1998,6,1980,24
Real Love,1992,1998,6,1992,0
Regulate,1994,2000,6,1994,0
Regulate,1994,2000,6,1994,0
Rescue Me,1991,1997,6,2015,24
Restless Heart,1992,1998,6,1980,12
Ride The Wind,1991,1997,6,1991,0
Ring The Alarm,2006,2000,6,2004,2
Roses,2004,1998,6,2004,0
Rump Shaker,1992,1998,6,1992,0
Run Away,1995,2001,6,1980,15
Run It!,2005,1999,6,2005,0
Save The Best For Last,1992,1998,6,2005,13
Say I,2006,2000,6,2012,6
She Talks To Angels,1991,1997,6,2003,12
She Thinks She Needs Me,2004,1998,6,2004,0
She's Playing Hard To Get,1992,1998,6,1980,12
Six Feet Deep,1993,1999,6,1993,0
Slow Dance (Hey Mr. DJ),1992,1998,6,1980,12
Smells Like Teen Spirit,1992,1998,6,1991,1
Somebody,2004,1998,6,2014,10
Someday,1991,1997,6,2002,11
Someone To Hold,1992,1998,6,1992,0
Somethin' To Ride To (Fonky Expedition),1994,2000,6,1994,0
Something To Talk About,1991,1997,6,1980,11
Stay,1992,1998,6,1995,3
Straight To Your Heart,1991,1997,6,1980,11
Strike It Up,1991,1997,6,2007,16
Take My Breath Away,2004,1998,6,2004,0
Take This Heart,1992,1998,6,1980,12
Take Time,1992,1998,6,1992,0
Talk About Our Love,2004,1998,6,2004,0
Tears In Heaven,1992,1998,6,1980,12
Tell Me What You Want Me To Do,1992,1998,6,1980,12
Temple Of Love,1991,1997,6,1991,0
That's What It's All About,2004,1998,6,2004,0
The Dream Is Still Alive,1991,1997,6,1980,11
The First Cut Is The Deepest,2004,1998,6,1980,24
The First Time,1991,1997,6,1980,11
The Hand That Feeds,2005,1999,6,2005,0
The More You Ignore Me The Closer I Get,1994,2000,6,1997,3
The Morning Papers,1993,1999,6,1993,0
The Perfect Drug,1997,2003,6,1980,17
The Reason,2004,1998,6,1980,24
The Star Spangled Banner,2001,1995,6,2004,3
The Truth,1991,1997,6,1983,8
The Way I Are,2007,2001,6,2015,8
The Way I Feel About You,1992,1998,6,1991,1
The World,2006,2000,6,1983,23
There She Goes,1991,1997,6,1997,6
These Boots Are Made For Walkin',2005,1999,6,2005,0
Thinkin' Back,1992,1998,6,1992,0
This Love,2004,1998,6,1980,24
To Be With You,1992,1998,6,1980,12
To Love Somebody,1992,1998,6,1992,0
Too Blind To See It,1992,1998,6,1980,12
Too Funky,1992,1998,6,1980,12
Toxic,2004,1998,6,2004,0
TRUE,2005,1999,6,1980,25
Truth Is,2005,1999,6,1980,25
Truth It,2005,1999,6,1980,25
Two Princes,1993,1999,6,1993,0
U And Dat,2006,2000,6,2006,0
Uhh Ahh,1992,1998,6,1992,0
Under The Bridge,1992,1998,6,2007,15
Until Your Love Comes Back Around,1992,1998,6,1980,12
Vertigo,2004,1998,6,2004,0
Very Special,1993,1999,6,1993,0
Voices That Care,1991,1997,6,1991,0
Waiting For Love,1991,1997,6,1980,11
Walking On Broken Glass,1992,1998,6,1980,12
Wanna Get To Know You,2004,1998,6,2004,0
Wannagirl,1993,1999,6,2005,12
We Got A Love Thang,1992,1998,6,2015,23
We Got A Love Thang,1992,1998,6,1980,12
Welcome To My Life,2004,1998,6,1980,24
What About Your Friends,1992,1998,6,1992,0
What Goes Around Comes Around,1992,1998,6,1980,12
What You Know,2006,2000,6,2006,0
What You Waiting For?,2004,1998,6,2005,1
When I Think About Cheatin',2005,1999,6,2013,8
White Flag,2004,1998,6,1980,24
Who You'd Be Today,2005,1999,6,1980,25
Whole Wide World,1990,1996,6,1990,0
Why,1992,1998,6,1980,12
Why Me Baby?,1992,1998,6,1992,0
Will You Marry Me?,1992,1998,6,1990,2
With Every Beat Of My Heart,1990,1996,6,1996,6
You Can't Hide Beautiful,2003,1997,6,2001,2
You Gotta Believe,1992,1998,6,2003,11
You Know How We Do It,1994,2000,6,1994,0
You Lied To Me,1992,1998,6,1992,0
You Won't See Me Cry,1992,1998,6,1980,12
(If There Was) Any Other Way,1991,1998,7,1980,11
1 Thing,2005,1998,7,1996,9
A Bay Bay,2007,2000,7,2005,2
A Better Love,1991,1998,7,1980,11
A Day In My Life (Without You),1991,1998,7,1980,11
A Real Fine Place To Start,2005,1998,7,2004,1
After The Rain,1991,1998,7,1996,5
After The Summer's Gone,1991,1998,7,1980,11
Again,2005,1998,7,2010,5
All I Need Is You,1991,1998,7,2012,21
All Jacked Up,2005,1998,7,2015,10
All The Man That I Need,1991,1998,7,1980,11
All True Man,1991,1998,7,1980,11
Almost,2005,1998,7,2000,5
American Baby,2005,1998,7,1980,25
Anything But Mine,2005,1998,7,1982,23
Anything Is Possible,1991,1998,7,1992,1
Around The Way Girl,1991,1998,7,1997,6
As Good As I Once Was,2005,1998,7,2000,5
Awful Beautiful Life,2005,1998,7,1991,14
B.Y.O.B.,2005,1998,7,2005,0
Baby Baby,1991,1998,7,1980,11
Baby Girl,2005,1998,7,1983,22
Baby Got Back,1992,1999,7,2004,12
Baby I'm Back,2005,1998,7,1998,7
Badd,2005,1998,7,2005,0
Be Yourself,2005,1998,7,2010,5
Beautiful Soul,2005,1998,7,1980,25
Because Of You,2005,1998,7,1980,25
Beep,2006,1999,7,1980,26
Behind These Hazel Eyes,2005,1998,7,2003,2
Belly Dancer (Bananza),2005,1998,7,2006,1
Best Of You,2005,1998,7,1980,25
Better Days,2005,1998,7,1980,25
Better Life,2005,1998,7,1980,25
Beverly Hills,2005,1998,7,2007,2
Bitter Tears,1991,1998,7,1980,11
Bless The Broken Road,2005,1998,7,1980,25
Blowing Kisses In The Wind,1991,1998,7,1980,11
Bring 'Em Out,2005,1998,7,2004,1
C'mon And Get My Love,1990,1997,7,1990,0
Call It Poison,1991,1998,7,2001,10
Can't Forget You,1991,1998,7,1980,11
Can't Truss It,1991,1998,7,2001,10
Candy,1991,1998,7,1991,0
Candy Shop,2005,1998,7,2006,1
Cater 2 U,2005,1998,7,2005,0
Caught Up,2005,1998,7,2005,0
Chasin' The Wind,1991,1998,7,1980,11
Close To You,1990,1997,7,1990,0
Come A Little Closer,2005,1998,7,2002,3
Come Back To Me,1990,1997,7,1997,7
Come With Me,1998,1991,7,1980,18
Coming Out Of The Dark,1991,1998,7,1999,8
Couple Days Off,1991,1998,7,1991,0
Cradle Of Love,1990,1997,7,1990,0
Crazy,1991,1998,7,1991,0
Cream,1991,1998,7,1980,11
Cry Baby/Piece Of My Heart,2005,1998,7,1984,21
Cry For Help,1991,1998,7,1980,11
Dangerous,1990,1997,7,1989,1
Daughters,2005,1998,7,1990,15
Dazzey Duks,1993,2000,7,1993,0
Diamonds From Sierra Leone,2005,1998,7,2001,4
Disappear,1991,1998,7,2004,13
Disco Inferno,2005,1998,7,2004,1
Do Anything,1991,1998,7,1991,0
Do You Want Me,1991,1998,7,1991,0
Does Anybody Really Fall In Love Anymore?,1991,1998,7,2001,10
Don't Bother,2005,1998,7,1998,7
Don't Cry,1991,1998,7,1980,11
Don't Forget About Us,2005,1998,7,2005,0
Don't Hold Back Your Love,1991,1998,7,1980,11
Don't Matter,2007,2000,7,2007,0
Don't Phunk With My Heart,2005,1998,7,2005,0
Don't Want To Be A Fool,1991,1998,7,2013,22
Dre Day,1993,2000,7,1993,0
Dreams,2005,1998,7,2005,0
Easy Come Easy Go,1991,1998,7,1980,11
Elevate My Mind,1991,1998,7,1991,0
Emotions,1991,1998,7,1980,11
Enter Sandman,1991,1998,7,2003,12
Every Heartbeat,1991,1998,7,1991,0
Everybody Plays The Fool,1991,1998,7,1991,0
Everyotherday,1991,1998,7,1980,11
Everytime Tha Beat Drop,2006,1999,7,2005,1
Exclusivity,1991,1998,7,2004,13
Face The Music,1991,1998,7,1980,11
Fading Like A Flower (Every Time You Leave),1991,1998,7,1980,11
Fast Cars And Freedom,2005,1998,7,2013,8
Felt Good On My Lips,2010,2003,7,2010,0
Fireman,2005,1998,7,2005,0
Foolish Games/You Were Meant For Me,1997,1990,7,1980,17
For You,1991,1998,7,1980,11
Forever My Lady,1991,1998,7,1980,11
Free Yourself,2005,1998,7,1997,8
Get A Leg Up,1991,1998,7,2006,15
Get Right,2005,1998,7,1989,16
Gett Off,1991,1998,7,1991,0
Girl,2005,1998,7,1980,25
Girl,2006,1999,7,2006,0
Girlfight,2005,1998,7,2005,0
Give A Little Bit,2005,1998,7,1980,25
Goin' Crazy,2005,1998,7,1980,25
Good Vibrations,1991,1998,7,1991,0
Got A Love For You,1991,1998,7,1980,11
Groovy Train,1991,1998,7,1991,0
Gypsy Woman (She's Homeless),1991,1998,7,1980,11
Hard To Handle,1991,1998,7,1990,1
Heart Of Stone,1990,1997,7,1980,10
Heartbreak Station,1991,1998,7,1980,11
Here And Now,1990,1997,7,1980,10
Here I Am (Come And Take Me),1991,1998,7,1980,11
Here We Are,1990,1997,7,1980,10
Here We Go,1991,1998,7,1991,0
Here We Go,1991,1998,7,1991,0
Hey Donna,1991,1998,7,1991,0
High Enough,1991,1998,7,1980,11
Hips Don't Lie,2006,1999,7,2006,0
Hold You Tight,1991,1998,7,1980,11
Hollaback Girl,2005,1998,7,2009,4
Honky Tonk Badonkadonk,2006,1999,7,2005,1
How Can I Ease The Pain,1991,1998,7,1980,11
How Much Is Enough,1991,1998,7,1991,0
How To Deal,2005,1998,7,1980,25
Hung Up,2005,1998,7,1980,25
I Can't Dance,1992,1999,7,2003,11
I Can't Wait Another Minute,1991,1998,7,1980,11
I Don't Know Anybody Else,1991,1998,7,1980,11
I Don't Wanna Cry,1991,1998,7,1982,9
I Don't Want To Be,2005,1998,7,2004,1
I Like The Way (The Kissing Game),1991,1998,7,1980,11
I Miss You,2004,1997,7,2004,0
I Should Have Cheated,2005,1998,7,2012,7
I Touch Myself,1991,1998,7,1991,0
I Wanna Sex You Up,1991,1998,7,2002,11
I Won't Tell,2008,2001,7,2008,0
I'll Be There,1991,1998,7,1980,11
I'll Be Your Shelter,1990,1997,7,1980,10
I'll Do 4 U,1991,1998,7,1991,0
I'll Give All My Love To You,1991,1998,7,1980,11
I'm So Hood,2007,2000,7,2007,0
I'm So Hood,2007,2000,7,2007,0
I'm So Paid,2008,2001,7,2008,0
I'm Sprung,2005,1998,7,1987,18
I've Been Thinking About You,1991,1998,7,1991,0
If It's Lovin' That You Want,2005,1998,7,1980,25
If We Were A Movie,2006,1999,7,1980,26
If You Needed Somebody,1991,1998,7,1991,0
Irreplaceable,2006,1999,7,2006,0
It Hit Me Like A Hammer,1991,1998,7,1986,5
It Never Rains (In Southern California),1991,1998,7,1980,11
It's A Shame (My Sister),1991,1998,7,1991,0
It's Like That,2005,1998,7,2005,0
It's So Hard To Say Goodbye To Yesterday,1991,1998,7,1991,0
Joyride,1991,1998,7,1984,7
Just A Touch Of Love,1991,1998,7,1980,11
Just Like You,1991,1998,7,1980,11
Just The Girl,2005,1998,7,2013,8
Just Want To Hold You,1991,1998,7,1980,11
Justify My Love,1991,1998,7,1990,1
Karma,2005,1998,7,2005,0
Karma,2005,1998,7,2004,1
Kickin' It,1992,1999,7,1980,12
Lady,2005,1998,7,2005,0
Let It Go,2007,2000,7,2007,0
Let It Go,2008,2001,7,1980,28
Let Me Hold You,2005,1998,7,2005,0
Let Me Love You,2005,1998,7,1980,25
Let The Beat Hit 'EM,1991,1998,7,1980,11
Let The Beat Hit 'Em,1991,1998,7,1980,11
Let's Chill,1991,1998,7,1980,11
Let's Talk About Sex,1991,1998,7,1993,2
Life Goes On,1991,1998,7,1980,11
Like A Boy,2007,2000,7,2001,6
Like Toy Soldiers,2005,1998,7,2005,0
Like We Never Loved At All,2005,1998,7,1980,25
Like You,2005,1998,7,2005,0
Listen To Your Heart,2005,1998,7,1992,13
Live For Loving You,1991,1998,7,1980,11
Live Like You Were Dying,2005,1998,7,2004,1
Lonely,2005,1998,7,2005,0
Lonely No More,2005,1998,7,1980,25
Look What You've Done,2005,1998,7,1980,25
Losing My Religion,1991,1998,7,1991,0
Love And Understanding,1991,1998,7,1980,11
Love Child,1990,1997,7,1990,0
Love Desire,1991,1998,7,1987,4
Love Is A Wonderful Thing,1991,1998,7,1991,0
Love Of A Lifetime,1991,1998,7,1980,11
Love On A Rooftop,1991,1998,7,1991,0
Love Will Lead You Back,1990,1997,7,1980,10
Love Will Never Do (Without You),1991,1998,7,1980,11
Love...Thy Will Be Done,1991,1998,7,1980,11
Make Her Feel Good,2005,1998,7,2005,0
Make Me Better,2007,2000,7,2007,0
Making Memories Of Us,2005,1998,7,2005,0
Maneater,2006,1999,7,1980,26
Meant To Live,2004,1997,7,1998,6
Miracle,1990,1997,7,1990,0
Miracle,1991,1998,7,1980,11
Mississippi Girl,2005,1998,7,2005,0
More Than Words,2005,1998,7,1980,25
Mr. Brightside,2005,1998,7,2005,0
Must Be Doin' Somethin' Right,2005,1998,7,2004,1
Must Be Nice,2005,1998,7,2005,0
My Body Says Yes,1991,1998,7,2008,17
My Name Is Not Susan,1991,1998,7,1981,10
Mysterious Ways,1992,1999,7,1991,1
Naked,2005,1998,7,2005,0
Nights Like This,1991,1998,7,1991,0
Nobody's Home,2005,1998,7,1980,25
Nothin' To Hide,1990,1997,7,1980,10
Nothin' To Lose,2005,1998,7,1991,14
O,2005,1998,7,2005,0
One And Only Man,1990,1997,7,1980,10
One Of Us,2010,2003,7,2010,0
One Wish,2006,1999,7,1999,7
Only Time Will Tell,1991,1998,7,1991,0
Only U,2005,1998,7,2002,3
Ooh!,2003,1996,7,1980,23
Opposites Attract,1990,1997,7,1989,1
P.A.S.S.I.O.N.,1991,1998,7,2002,11
Party Like A Rockstar,2007,2000,7,2012,5
Photograph,2005,1998,7,2003,2
Pink,1998,1991,7,1980,18
Policy Of Truth,1990,1997,7,2006,16
Pon de Replay,2005,1998,7,2014,9
Possession,1990,1997,7,1980,10
Pump Up The Jam,1990,1997,7,1980,10
Rain Is A Good Thing,2010,2003,7,2010,0
Real Real Real,1991,1998,7,1980,11
Remedy,1992,1999,7,1985,7
Remember When,2004,1997,7,2003,1
Rich Girl,2005,1998,7,2005,0
Right Here Right Now,1991,1998,7,1980,11
Ring My Bell,1991,1998,7,1991,0
Romantic,1991,1998,7,2005,14
Running Back To You,1991,1998,7,1991,0
Rush Rush,1991,1998,7,1980,11
S.O.S.,2007,2000,7,2012,5
Same Girl,2007,2000,7,2007,0
Save Some Love,1991,1998,7,1991,0
Scars,2005,1998,7,2005,0
See The Lights,1991,1998,7,1980,11
Selling The Drama,1994,2001,7,1994,0
Sending All My Love,1990,1997,7,1980,10
Sensitivity,1991,1998,7,1988,3
Set Adrift On Memory Bliss,1991,1998,7,1991,0
Set The Night To Music,1991,1998,7,1980,11
Settle For A Slowdown,2006,1999,7,2006,0
Sexy Can I,2008,2001,7,2008,0
Shake It Off,2005,1998,7,2005,0
She Will Be Loved,2004,1997,7,1980,24
She's Everything,2006,1999,7,2006,0
Shelter Me,1991,1998,7,1991,0
Shiny Happy People,1991,1998,7,1980,11
Shoop,1993,2000,7,1993,0
Shot Of Poison,1991,1998,7,1986,5
Signs,2005,1998,7,2005,0
Signs,1991,1998,7,1993,2
Silent Lucidity,1991,1998,7,1991,0
Since U Been Gone,2005,1998,7,2000,5
Single Ladies (Put A Ring On It),2008,2001,7,2008,0
Sleeping Satellite,1993,2000,7,2013,20
Slow Down,2005,1998,7,2005,0
Smile,2007,2000,7,2003,4
Some Cut,2005,1998,7,2005,0
Something Got Me Started,1991,1998,7,1980,11
Something In My Heart,1991,1998,7,1992,1
Something To Be Proud Of,2005,1998,7,2005,0
Sometimes She Cries,1990,1997,7,2001,11
Speed Of Sound,2005,1998,7,2005,0
Spending My Time,1992,1999,7,1980,12
Stay,1992,1999,7,1980,12
Stay With Me (Brass Bed),2005,1998,7,1980,25
Stickwitu,2005,1998,7,2005,0
Stone Cold Gentleman,1991,1998,7,1995,4
Street Of Dreams,1991,1998,7,1980,11
Sugar (Gimme Some),2005,1998,7,2005,0
Sugar We're Goin' Down,2005,1998,7,2005,0
Summer Love,2007,2000,7,1980,27
Summer Nights,2005,1998,7,2005,0
Summer Rain,1990,1997,7,1990,0
Sunday Morning,2005,1998,7,2005,0
Switch,2005,1998,7,2005,0
Tbe Best Things In Life Are Free,1992,1999,7,1991,1
Tell Me,2006,1999,7,2006,0
Temptation,1991,1998,7,1991,0
Tempted To Touch,2004,1997,7,1980,24
Tender Kisses,1991,1998,7,2005,14
The Diary Of Jane,2006,1999,7,1980,26
The One And Only,1991,1998,7,1991,0
The Promise Of A New Day,1991,1998,7,1980,11
The Real Love,1991,1998,7,1991,0
The Riddle,2006,1999,7,1981,25
The Secret Garden,1990,1997,7,1990,0
The Way That I Love You,2008,2001,7,2013,5
Things That Make You Go Hmmmm...,1991,1998,7,1991,0
This House,1991,1998,7,1991,0
This Is The Right Time,1990,1997,7,1980,10
This One's For The Children,1990,1997,7,1980,10
TiK ToK,2010,2003,7,2009,1
Ticks,2007,2000,7,2007,0
Time After Time,1990,1997,7,1980,10
Time For Letting Go,1990,1997,7,2001,11
Time Love And Tenderness,1991,1998,7,1991,0
Together Forever,1991,1998,7,1980,11
Too Late To Say Goodbye,1990,1997,7,1990,0
Too Much Of A Good Thing,2004,1997,7,1980,24
Top Of The World,1991,1998,7,1990,1
Touch My Body,2008,2001,7,2011,3
Trapped In The Closet,2005,1998,7,2003,2
Unbelievable,1991,1998,7,1998,7
Unchained Melody,1990,1997,7,1980,10
Unchained Melody (new version),1990,1997,7,1980,10
Unfaithful,2006,1999,7,2006,0
Waiting For That Day,1991,1998,7,2004,13
Wake Me Up When September Ends,2005,1998,7,2003,2
Wake Up,2005,1998,7,2005,0
Walk Away,2006,1999,7,1980,26
Walk Through Fire,1991,1998,7,1980,11
Wasted,2007,2000,7,2007,0
We Belong Together,2006,1999,7,1981,25
We Belong Together,2005,1998,7,2005,0
What Comes Naturally,1991,1998,7,1980,11
Whatever You Want,1991,1998,7,1991,0
When A Man Loves A Woman,1991,1998,7,1996,5
When I'm Back On My Feet Again,1990,1997,7,1990,0
When I'm Gone,2005,1998,7,2005,0
When You Tell Me That You Love Me,2005,1998,7,1980,25
When You're Mad,2006,1999,7,1993,13
Where Does My Heart Beat Now,1991,1998,7,1991,0
Wherever Would I Be,1990,1997,7,1980,10
Why You Wanna,2006,1999,7,2002,4
Wild Women Do,1990,1997,7,1980,10
Wipe Me Down,2007,2000,7,2007,0
With You,1991,1998,7,1982,9
Woman In Chains,1990,1997,7,1982,8
Would I Lie To You?,1992,1999,7,2003,11
Would I Lie To You?,1992,1999,7,2003,11
Written All Over Your Face,1991,1998,7,1980,11
You Can't Deny It,1990,1997,7,1990,0
You Could Be Mine,1991,1998,7,1991,0
You Don't Have To Go Home Tonight,1991,1998,7,1980,11
You Gotta Love Someone,1991,1998,7,1980,11
You Remind Me,1992,1999,7,1980,12
You'll Think Of Me,2004,1997,7,2012,8
You're Amazing,1991,1998,7,1980,11
Your Song,1992,1999,7,2014,22
(Can't Live Without Your) Love And Affection,1990,1998,8,2005,15
(When You Gonna) Give It Up To Me,2006,1998,8,2004,2
3 A.M. Eternal,1991,1999,8,1999,8
A Face In The Crowd,1990,1998,8,1980,10
A Girl Like You,1990,1998,8,1998,8
A Little Love,1990,1998,8,1983,7
A Public Affair,2006,1998,8,2008,2
About Us,2006,1998,8,2009,3
Across The River,1990,1998,8,1984,6
Across The Universe,2005,1997,8,2009,4
Ain't No Other Man,2006,1998,8,1980,26
All Around The World,1990,1998,8,1989,1
All I Do Is Think Of You,1990,1998,8,1980,10
All I Wanna Do Is Make Love To You,1990,1998,8,1980,10
All I'm Missing Is You,1990,1998,8,2010,20
All My Life,1990,1998,8,1986,4
All Or Nothing,1990,1998,8,1980,10
All That Glitters Isn't Gold,1990,1998,8,1980,10
Almost Hear You Sigh,1990,1998,8,1980,10
Alright,1990,1998,8,1980,10
Always And Forever,1990,1998,8,1980,10
Always On Your Side,2006,1998,8,2003,3
And So It Goes,1990,1998,8,1981,9
Another Day In Paradise,1990,1998,8,1980,10
Anything I Want,1990,1998,8,2003,13
B.B.D. (I Thought It Was Me)?,1990,1998,8,1991,1
Baby It's Tonight,1990,1998,8,1985,5
Bad Day,2006,1998,8,1980,26
Bad Of The Heart,1990,1998,8,2007,17
Bang Bang,1990,1998,8,2012,22
Banned In The U.S.A.,1990,1998,8,1994,4
Be Without You,2006,1998,8,2006,0
Because I Love You (The Postman Song),1990,1998,8,1980,10
Best Friend,2006,1998,8,2009,3
Black Cat,1990,1998,8,1980,10
Black Horse & The Cherry Tree,2006,1998,8,2012,6
Black Velvet,1990,1998,8,1990,0
Blaze Of Glory,1990,1998,8,1999,9
Blue Sky Mine,1990,1998,8,1990,0
Boondocks,2006,1998,8,2000,6
Boulevard Of Broken Dreams,2005,1997,8,2004,1
Boyfriend,2005,1997,8,1997,8
Brand New Girlfriend,2006,1998,8,2006,0
Breaking Free,2006,1998,8,2010,4
Breathe (2 AM),2006,1998,8,2012,6
Buttons,2006,1998,8,2006,0
Call Me When You're Sober,2006,1998,8,2012,6
Call On Me,2006,1998,8,1980,26
Can't Get Enuff,1990,1998,8,2000,10
Can't Stop,1990,1998,8,1980,10
Can't Stop Falling Into Love,1990,1998,8,1980,10
Can't Tell Me Nothing,2007,1999,8,2002,5
Chariot,2005,1997,8,2014,9
Chasing Cars,2006,1998,8,1980,26
Check On It,2006,1998,8,2005,1
Check Yo Self,1993,2001,8,1993,0
Check Yo Self,1993,2001,8,1993,0
Chemicals React,2006,1998,8,2009,3
Cherry Pie,1990,1998,8,1990,0
Chicken Fried,2008,2000,8,1980,28
Children Of The Night,1990,1998,8,1980,10
Club At The End Of The Street,1990,1998,8,1990,0
Clumsy,2007,1999,8,2007,0
Collide,2005,1997,8,1980,25
Come To Me,2006,1998,8,2006,0
Control Myself,2006,1998,8,2006,0
Corona And Lime,2008,2000,8,2008,0
Could This Be Love,1990,1998,8,1980,10
Crash,2006,1998,8,2006,0
Crazy,2006,1998,8,2001,5
Crazy,1990,1998,8,1990,0
Cruising For Bruising,1990,1998,8,1980,10
Cuts Both Ways,1990,1998,8,1980,10
DJ Play A Love Song,2006,1998,8,2002,4
Dance Dance,2006,1998,8,2005,1
Dangerous,2008,2000,8,2008,0
Dani California,2006,1998,8,2006,0
Dare To Fall In Love,1990,1998,8,2005,15
Deadbeat Club,1990,1998,8,1990,0
Deja Vu,2006,1998,8,2006,0
Dirty Cash (Money Talks),1990,1998,8,1990,0
Dirty Deeds,1990,1998,8,1980,10
Dirty Little Secret,2006,1998,8,1980,26
Do I Make You Proud,2006,1998,8,1980,26
Do It Well,2007,1999,8,1984,23
Do Me!,1990,1998,8,1990,0
Do You Remember?,1990,1998,8,1980,10
Doing Too Much,2006,1998,8,2006,0
Don't Forget To Remember Me,2006,1998,8,2006,0
Don't Go Away Mad (Just Go Away),1990,1998,8,1980,10
Don't Wanna Fall In Love,1990,1998,8,1980,10
Doubleback,1990,1998,8,1980,10
Enjoy The Silence,1990,1998,8,1990,0
Enough Cryin,2006,1998,8,1992,14
Epic,1990,1998,8,1990,0
Escapade,1990,1998,8,1999,9
Ever The Same,2006,1998,8,1980,26
Everybody Everybody,1990,1998,8,2014,24
Everything,1990,1998,8,1980,10
Everything,2007,1999,8,1980,27
Everytime We Touch,2006,1998,8,1980,26
Expression,1990,1998,8,1990,0
Fairweather Friend,1990,1998,8,1980,10
Falsetto,2008,2000,8,2008,0
Far Away,2006,1998,8,2006,0
Feels Good,1990,1998,8,2010,20
Flashing Lights,2008,2000,8,2007,1
Fly High Michelle,1990,1998,8,1990,0
Fly To The Angels,1990,1998,8,1980,10
For You I Will (Confidence),2006,1998,8,2006,0
Forever,1990,1998,8,1980,10
Free Fallin',1990,1998,8,1989,1
Freedom,1990,1998,8,1990,0
From A Distance,1990,1998,8,2004,14
Funhouse,2009,2001,8,2008,1
Gallery,2006,1998,8,2006,0
Georgia On My Mind,1990,1998,8,1980,10
Get Drunk And Be Somebody,2006,1998,8,2012,6
Get Up,2006,1998,8,2006,0
Get'cha Head In The Game,2006,1998,8,1980,26
Gettin' Some,2006,1998,8,2006,0
Getting Away With It,1990,1998,8,1996,6
Girl Next Door,2006,1998,8,1982,24
Girls Nite Out,1990,1998,8,1980,10
Girls Nite out,1990,1998,8,1980,10
Giving You The Benefit,1990,1998,8,2005,15
Glamorous,2007,1999,8,2007,0
Goodbye For Now,2006,1998,8,1980,26
Groove Is In The Heart,1990,1998,8,1990,0
Hands,1999,1991,8,1980,19
Hanky Panky,1990,1998,8,1990,0
Happy Xmas (War Is Over),2006,1998,8,1980,26
Hate Me,2006,1998,8,2006,0
Hate That I Love You,2007,1999,8,1980,27
Have You Seen Her,1990,1998,8,1990,0
Heart Like A Wheel,1990,1998,8,1985,5
Heart Of Stone,1990,1998,8,1990,0
Heartbeat,1990,1998,8,1990,0
Here It Goes Again,2006,1998,8,2006,0
Hippychick,1990,1998,8,1990,0
Hold On,1990,1998,8,1980,10
Hold On,1990,1998,8,1980,10
Hole Hearted,1991,1999,8,1991,0
House Of Pain,1990,1998,8,1990,0
How Am I Supposed To Live Without You,1990,1998,8,1980,10
How Much Love,1990,1998,8,1980,10
How To Save A Life,2006,1998,8,2006,0
Hurting Kind (I've Got My Eyes On You),1990,1998,8,1980,10
I Believe,2004,1996,8,2002,2
I Didn't Want To Need You,1990,1998,8,1980,10
I Don't Have The Heart,1990,1998,8,1991,1
I Go To Extremes,1990,1998,8,1985,5
I Love My B****,2006,1998,8,2009,3
I Loved Her First,2006,1998,8,2012,6
I Luv It,2006,1998,8,2006,0
I Remember You,1990,1998,8,1980,10
I Saw Red,1991,1999,8,1980,11
I Wanna Be Rich,1990,1998,8,1980,10
I Wanna Get With U,1990,1998,8,2005,15
I Want You,1990,1998,8,1989,1
I'd Rather Go Blind,1990,1998,8,1980,10
I'll Be Good To You,1990,1998,8,1989,1
I'll Be Your Everything,1990,1998,8,1980,10
I'll See You In My Dreams,1990,1998,8,1980,10
I'm Not In Love,1991,1999,8,1980,11
I'm Your Baby Tonight,1990,1998,8,1980,10
If U Were Mine,1990,1998,8,1990,0
If Wishes Came True,1990,1998,8,1997,7
If You Leave Me Now,1990,1998,8,1990,0
If You're Going Through Hell (Before the Devil Ev,2006,1998,8,2006,0
If You're Going Through Hell (Before the Devil Eve,2006,1998,8,2006,0
If You're Reading This,2007,1999,8,1980,27
In The Ayer,2008,2000,8,2008,0
Incomplete,2005,1997,8,1980,25
Independent,2008,2000,8,2008,0
Invisible,2006,1998,8,1980,26
It Ends Tonight,2007,1999,8,2006,1
It Must Have Been Love,1990,1998,8,1980,10
Jesus Take The Wheel,2006,1998,8,1980,26
Jump,1992,2000,8,1992,0
Just A Friend,1990,1998,8,1990,0
Just Between You And Me,1990,1998,8,1989,1
Just Kickin' It,1993,2001,8,1995,2
Just Like Jesse James,1990,1998,8,2006,16
Keep Holding On,2006,1998,8,1980,26
Keep It Together,1990,1998,8,1980,10
King Of Wishful Thinking,1990,1998,8,2009,19
Kiss You Back,1992,2000,8,1992,0
Kissing You,1991,1999,8,1980,11
Last Day Of My Life,2006,1998,8,1981,25
Learning To Fly,1991,1999,8,1980,11
Leave The Pieces,2006,1998,8,1980,26
Let U Go,2006,1998,8,2006,0
Letting Go (Dutty Love),2010,2002,8,2012,2
Life Is A Highway,2006,1998,8,2006,0
Like This,2007,1999,8,2007,0
Lips Of An Angel,2006,1998,8,1980,26
Live Your Life,2008,2000,8,2008,0
Lolli Lolli (Pop That Body),2008,2000,8,2008,0
Love,2006,1998,8,1980,26
Love And Emotion,1990,1998,8,1980,10
Love At First Sight,1991,1999,8,1980,11
Love Me For Life,1990,1998,8,1981,9
Love Song,1990,1998,8,1989,1
Love Takes Time,1990,1998,8,1980,10
Lyin' To Myself,1990,1998,8,1990,0
Make It Like It Was,1990,1998,8,1995,5
Make You Sweat,1990,1998,8,1980,10
Masterpiece,1992,2000,8,1980,12
Me & U,2006,1998,8,1980,26
Miss Independent,2008,2000,8,1980,28
Miss Murder,2006,1998,8,2006,0
Missunderstanding,1990,1998,8,1990,0
Money In The Bank,2006,1998,8,2006,0
Money Maker,2006,1998,8,2006,0
Mother's Pride,1991,1999,8,2002,11
Motownphilly,1991,1999,8,1991,0
Move Along,2006,1998,8,1980,26
Move This,1992,2000,8,1992,0
Mrs. Officer,2008,2000,8,1993,15
Mud On The Tires,2005,1997,8,2012,7
My Kinda Girl,1990,1998,8,1980,10
My Last,2011,2003,8,2011,0
My Little Girl,2006,1998,8,1980,26
My Love,2006,1998,8,1980,26
My Love Is A Fire,1990,1998,8,1980,10
My Wish,2006,1998,8,1980,26
My My My,1990,1998,8,1990,0
New York Minute,1990,1998,8,1980,10
Nicety,1990,1998,8,1990,0
Nothing Compares 2 U,1990,1998,8,1990,0
Notice Me,1990,1998,8,1980,10
O.P.P.,1991,1999,8,1991,0
Oh Father,1990,1998,8,1980,10
Oh Girl,1990,1998,8,1980,10
On The Hotline,2007,1999,8,1985,22
Ooh La La (I Can't Get Over You),1990,1998,8,2004,14
Ooops Up,1990,1998,8,1991,1
Over My Head (Cable Car),2006,1998,8,2006,0
Party In The U.S.A.,2009,2001,8,2009,0
Peace In Our Time,1990,1998,8,1989,1
Personal Jesus,1990,1998,8,1990,0
Pieces Of Me,2004,1996,8,1980,24
Play That Funky Music,1991,1999,8,1990,1
Playground,1991,1999,8,1991,0
Pop Bottles,2008,2000,8,2007,1
Pray,1990,1998,8,1980,10
Praying For Time,1990,1998,8,1981,9
Price Of Love,1990,1998,8,1980,10
Principal's Office,1990,1998,8,1989,1
Promiscuous,2006,1998,8,2005,1
Ready Or Not,1990,1998,8,1991,1
Real Love,1990,1998,8,1980,10
Release Me,1990,1998,8,1990,0
Rhythm Nation,1990,1998,8,1989,1
Right Where You Want Me,2006,1998,8,1992,14
Roam,1990,1998,8,1990,0
Rodeo,2006,1998,8,2004,2
Romeo,1990,1998,8,1993,3
Round And Round,1991,1999,8,1991,0
Rush,1991,1999,8,1990,1
S.E.X.,2006,1998,8,2006,0
Sacrifice,1990,1998,8,1990,0
Save Me,1990,1998,8,1980,10
Say A Prayer,1990,1998,8,1980,10
Sensual Seduction,2008,2000,8,1986,22
Sexy Love,2006,1998,8,2010,4
SexyBack,2006,1998,8,1980,26
She Ain't Worth It,1990,1998,8,1990,0
She Got It,2008,2000,8,2008,0
Shiftwork,2008,2000,8,2003,5
Shortie Like Mine,2006,1998,8,2006,0
Show Me What You Got,2006,1998,8,2006,0
Sittin' In The Lap Of Luxury,1990,1998,8,1990,0
Skin (Sarabeth),2005,1997,8,2005,0
Slow Motion,1992,2000,8,1996,4
So Close,1990,1998,8,2005,15
So Fly,2008,2000,8,2009,1
So What,2006,1998,8,2004,2
Solo,2010,2002,8,2010,0
Something Happened On The Way To Heaven,1990,1998,8,1980,10
Something More,2005,1997,8,1997,8
Somewhere Only We Know,2005,1997,8,2005,0
Somewhere Over The Rainbow,2006,1998,8,2006,0
Spend My Life,1991,1999,8,1980,11
Stand,2007,1999,8,1981,26
Stars Are Blind,2006,1998,8,2006,0
Steamy Windows,1990,1998,8,1991,1
Step By Step,1990,1998,8,1980,10
Stranded,1990,1998,8,1980,10
Stupid Boy,2007,1999,8,1980,27
Suicide Blonde,1990,1998,8,1990,0
Summer Nights,2009,2001,8,2009,0
Summertime,1991,1999,8,1991,0
Take Me There,2007,1999,8,1980,27
Talk To Me,1990,1998,8,1980,10
Tell Me Something,1990,1998,8,1980,10
Tell Me Why,1990,1998,8,1980,10
That's That,2006,1998,8,2006,0
That's What Love Is For,1991,1999,8,1991,0
That's What Love is For,1991,1999,8,1991,0
The Ballad Of Jayne,1990,1998,8,1980,10
The Ghetto,1991,1999,8,1990,1
The Girl I Used To Know,1990,1998,8,1980,10
The Heart Of The Matter,1990,1998,8,1990,0
The Power,1990,1998,8,1990,0
The Sweet Escape,2007,1999,8,1984,23
The Way I Am,2007,1999,8,2006,1
The Way You Do The Things You Do,1990,1998,8,1980,10
The World I Know,2008,2000,8,1996,12
These Are My People,2007,1999,8,2007,0
Think,1990,1998,8,1980,10
This Old Heart Of Mine,1990,1998,8,1990,0
Thnks Fr Th Mmrs,2007,1999,8,2007,0
Through Glass,2007,1999,8,2006,1
Tonight I Wanna Cry,2006,1998,8,1984,22
Too Little Too Late,2006,1998,8,1980,26
Torn,2006,1998,8,1980,26
True Blue Love,1990,1998,8,1990,0
Two To Make It Right,1990,1998,8,1980,10
Unappreciated,2006,1998,8,2006,0
Unpredictable,2006,1998,8,2005,1
Unskinny Bop,1990,1998,8,1990,0
Until The End Of Time,2007,1999,8,1980,27
Untitled (How Can This Happen To Me?),2005,1997,8,1980,25
Unwritten,2006,1998,8,2006,0
Vision Of Love,1990,1998,8,1997,7
Vogue,1990,1998,8,1990,0
Waitin' On A Woman,2008,2000,8,2001,7
Want To,2006,1998,8,1980,26
Was It Nothing At All,1990,1998,8,1980,10
We Can't Go Wrong,1990,1998,8,1980,10
What Kind Of Man Would I Be?,1990,1998,8,1980,10
What's Left Of Me,2006,1998,8,1980,26
When I Dream Of You,1990,1998,8,1980,10
When I Get Where I'm Going,2006,1998,8,1980,26
When You Were Young,2006,1998,8,1980,26
Who Says You Can't Go Home,2006,1998,8,1983,23
Wicked Game,1991,1999,8,1980,11
Wildside,1991,1999,8,1991,0
Without You,1990,1998,8,1990,0
World Wide Suicide,2006,1998,8,2013,7
Would You Go With Me,2006,1998,8,2006,0
Yo (Excuse Me Miss),2006,1998,8,2006,0
You Know What It Is,2007,1999,8,2007,0
You Save Me,2006,1998,8,1996,10
You Showed Me,1992,2000,8,1980,12
You're A God,2000,1992,8,1980,20
You're Gonna Miss This,2008,2000,8,2008,0
You're In Love,1991,1999,8,1980,11
You're My Better Half,2005,1997,8,2005,0
You're The Only Woman,1990,1998,8,1990,0
Your Baby Never Looked Good In Blue,1990,1998,8,1980,10
Your Love Is My Drug,2010,2002,8,2002,8
#thatPOWER,2013,2004,9,1980,33
(You Want To) Make A Memory,2007,1998,9,1980,27
1234,2007,1998,9,1991,16
2 Step,2007,1998,9,2014,7
Anonymous,2007,1998,9,1990,17
Anyway,2007,1998,9,1980,27
Apologize,2007,1998,9,1980,27
Ayo Technology,2007,1998,9,1982,25
Baby By Me,2009,2000,9,2001,8
Baby Don't Go,2007,1998,9,1998,9
Bang Bang Pow Pow,2011,2002,9,2008,3
Bartender,2007,1998,9,2008,1
Beautiful Liar,2007,1998,9,2004,3
Because Of You,2007,1998,9,1980,27
Because Of You,2007,1998,9,1980,27
Bed,2007,1998,9,2001,6
Before He Cheats,2007,1998,9,2010,3
Bet On It,2007,1998,9,1980,27
Better Than Me,2007,1998,9,1980,27
Big Girls Don't Cry,2007,1998,9,1980,27
Big Things Poppin' (Do It),2007,1998,9,2005,2
Boston,2007,1998,9,1991,16
Bubbly,2007,1998,9,2007,0
Bubbly,2007,1998,9,2007,0
Buddy,2007,1998,9,2007,0
Can't Help But Wait,2007,1998,9,2004,3
Can't Leave 'Em Alone,2007,1998,9,2005,2
Candyman,2007,1998,9,2007,0
Cashin Out,2012,2003,9,2012,0
Cashin' Out,2012,2003,9,2012,0
Clothes Off!!,2007,1998,9,2006,1
Cool,2005,1996,9,2005,0
Cupid's Chokehold,2007,1998,9,2007,0
Desert Rose,2000,1991,9,1980,20
Do You,2007,1998,9,1999,8
Do You Know? (The Ping Pong Song)/Dimelo,2007,1998,9,2010,3
Don't Blink,2007,1998,9,1990,17
Dreamer,2008,1999,9,1980,28
Duffle Bag Boy,2007,1998,9,2007,0
Every Mile A Memory,2006,1997,9,1980,26
First Time,2007,1998,9,1980,27
Free And Easy (Down The Road I Go),2007,1998,9,2007,0
Gangsta Luv,2010,2001,9,2009,1
Get It Shawty,2007,1998,9,2007,0
Get Up! (Before the Night Is Over),1990,1999,9,1980,10
Gimme More,2007,1998,9,2007,0
Gimme That,2006,1997,9,2006,0
Girlfriend,2007,1998,9,2003,4
Girlfriend,2007,1998,9,2007,0
Go Getta,2007,1998,9,2007,0
Good Directions,2007,1998,9,2007,0
Good Life,2007,1998,9,2007,0
Gotta Go My Own Way,2007,1998,9,2006,1
Green Light,2008,1999,9,2008,0
Hard,2010,2001,9,2009,1
Have A Heart,1990,1999,9,1980,10
Hey There Delilah,2007,1998,9,1987,20
Hip Hop Is Dead,2007,1998,9,2002,5
Home,2007,1998,9,1980,27
Hot N Cold,2008,1999,9,2008,0
How Bad Do You Want It?,1990,1999,9,1990,0
How Can We Be Lovers,1990,1999,9,1990,0
How Do I Breathe,2007,1998,9,2008,1
How Far We've Come,2007,1998,9,2007,0
How Low,2010,2001,9,2009,1
Human,2008,1999,9,2001,7
Hurt,2006,1997,9,1980,26
Hypnotized,2007,1998,9,2007,0
I Love College,2009,2000,9,2009,0
I Need You,2007,1998,9,1989,18
I Tried,2007,1998,9,2007,0
I Wish It Would Rain Down,1990,1999,9,1980,10
I'm A Flirt,2007,1998,9,2007,0
Ice Box,2007,1998,9,1994,13
If Everyone Cared,2007,1998,9,1980,27
Inside Your Heaven,2005,1996,9,1983,22
Inside Your Heaven,2005,1996,9,1983,22
It's Not Over,2007,1998,9,1980,27
Jerk Out,1990,1999,9,1990,0
Joey,1990,1999,9,1990,0
Just A Dream,2008,1999,9,2014,6
Just Another Dream,1991,2000,9,1980,11
Keeps Gettin' Better,2008,1999,9,2009,1
Kiss This Thing Goodbye,1990,1999,9,1990,0
Knockout,2010,2001,9,2011,1
Last Dollar (Fly Away),2007,1998,9,2007,0
Last Night,2007,1998,9,1980,27
Learn To Fly,2000,1991,9,1980,20
Let It Rock,2008,1999,9,2008,0
Letter To Me,2008,1999,9,2008,0
Lies,1990,1999,9,1990,0
Life's What You Make It,2007,1998,9,1980,27
Like This,2007,1998,9,2007,0
Love In This Club,2008,1999,9,2004,4
Love In This Club Part II,2008,1999,9,2004,4
Love Me If You Can,2007,1998,9,1985,22
LoveGame,2009,2000,9,2009,0
LoveStoned,2007,1998,9,2007,0
Made In America,2011,2002,9,2011,0
Make It Rain,2007,1998,9,2006,1
Makes Me Wonder,2007,1998,9,1980,27
Misery Business,2008,1999,9,2009,1
More Than Words Can Say,1990,1999,9,1980,10
Never Again,2007,1998,9,1980,27
Ni**as In Paris,2012,2003,9,2011,1
Nobody's Perfect,2007,1998,9,1997,10
Not Ready To Make Nice,2007,1998,9,1980,27
Nothing Left To Lose,2007,1998,9,1999,8
Once In A Lifetime,2006,1997,9,1980,26
Outta My System,2007,1998,9,2007,0
Pain,2007,1998,9,1980,27
Picture To Burn,2008,1999,9,1988,20
Piece Of My Heart,1991,2000,9,1980,11
Please Don't Go,2007,1998,9,1980,27
Poison,1990,1999,9,1990,0
Poppin',2007,1998,9,2008,1
Potential Breakup Song,2007,1998,9,2002,5
Pure,1990,1999,9,1990,0
Push It To The Limit,2007,1998,9,2011,4
Rehab,2007,1998,9,2014,7
Right Here (Departed),2008,1999,9,2004,4
Roll With Me,2008,1999,9,1980,28
Runaway Love,2007,1998,9,2006,1
Savin' Me,2006,1997,9,2004,2
Say Goodbye,2006,1997,9,1980,26
Say Hey (I Love You),2009,2000,9,2009,0
Say Hey (I Love You),2009,2000,9,2009,0
Say Hey (I Love You),2009,2000,9,2009,0
Say It Right,2007,1998,9,1980,27
Shadow Of The Day,2008,1999,9,1980,28
Shawty,2007,1998,9,2007,0
Shoulda Let You Go,2007,1998,9,2007,0
So Sick,2006,1997,9,2014,8
Something To Believe In,1990,1999,9,1984,6
Sorry Blame It On Me,2007,1998,9,1980,27
Soulja Girl,2007,1998,9,2007,0
Stay,2007,1998,9,1980,27
Stolen,2007,1998,9,1987,20
Strip,2012,2003,9,2010,2
Strip,2012,2003,9,2010,2
Stupid Girls,2006,1997,9,1997,9
Successful,2009,2000,9,2009,0
Suddenly I See,2007,1998,9,1980,27
Sweetest Girl (Dollar Bill),2008,1999,9,2007,1
Talk That Talk,2011,2002,9,1995,16
Tattoo,2007,1998,9,1980,27
Teardrops On My Guitar,2008,1999,9,1980,28
The Blues,1990,1999,9,1980,10
The Business,2008,1999,9,2008,0
The Day That Never Comes,2008,1999,9,2002,6
The Deeper The Love,1990,1999,9,1980,10
The Great Escape,2007,1998,9,2007,0
The Great Escape,2007,1998,9,2007,0
The Motown Song,1991,2000,9,1980,11
The Pretender,2007,1998,9,2007,0
The River,2007,1998,9,1992,15
Thieves In The Temple,1990,1999,9,1980,10
This Is Me,2008,1999,9,1980,28
This Is My Now,2007,1998,9,1980,27
Tim McGraw,2007,1998,9,2006,1
Tom's Diner,1990,1999,9,1990,0
Tonight,1990,1999,9,1990,0
Tonight (I'm Lovin' You),2011,2002,9,2012,1
Trading Places,2008,1999,9,2006,2
Turn Down For What,2014,2005,9,1980,34
U + Ur Hand,2007,1998,9,2007,0
U Can't Touch This,1990,1999,9,1990,0
Umbrella,2007,1998,9,2007,0
Up All Night,1990,1999,9,1980,10
Wadsyaname,2007,1998,9,1998,9
Wait A Minute,2007,1998,9,1992,15
Wait For You,2007,1998,9,1980,27
Waiting On The World To Change,2007,1998,9,1996,11
Wake Up Call,2007,1998,9,2010,3
Waking Up In Vegas,2009,2000,9,1980,29
Wanted Dead Or Alive,2006,1997,9,1980,26
Watching You,2007,1998,9,2006,1
We Rock,2008,1999,9,1980,28
Welcome To The Black Parade,2007,1998,9,1998,9
Welcome To The Real World,1990,1999,9,1982,8
What Goes Around...Comes Around,2007,1998,9,1980,27
What Hurts The Most,2006,1997,9,1981,25
What Time Is It,2007,1998,9,1988,19
What You Got,2008,1999,9,2007,1
When I Grow Up,2008,1999,9,2014,6
When I See U,2007,1998,9,1996,11
When You're Gone,2007,1998,9,1980,27
Who Are You When I'm Not Looking,2011,2002,9,2013,2
Who Knew,2007,1998,9,1980,27
Work Hard Play Hard,2012,2003,9,2010,2
You,2007,1998,9,2008,1
You're Not Sorry,2008,1999,9,1980,28
Your Man,2006,1997,9,1980,26
teachme,2007,1998,9,2007,0
4 Minutes,2008,1998,10,1980,28
7 Things,2008,1998,10,1985,23
7 Things,2008,1998,10,1985,23
A Little Bit Longer,2008,1998,10,1980,28
A Milli,2008,1998,10,2008,0
Addicted,2008,1998,10,1980,28
Ain't No Sunshine,2009,1999,10,1980,29
All Around Me,2008,1998,10,1980,28
All I Want To Do,2008,1998,10,1980,28
All Summer Long,2008,1998,10,2008,0
All Summer Long,2008,1998,10,2008,0
All Summer Long,2008,1998,10,2008,0
All-American Girl,2008,1998,10,2011,3
Already Gone,2008,1998,10,2012,4
American Boy,2008,1998,10,2006,2
Beat It,2008,1998,10,1980,28
Beautiful,2008,1998,10,1989,19
Better As A Memory,2008,1998,10,2015,7
Bleeding Love,2008,1998,10,1985,23
Body On Me,2008,1998,10,2005,3
Break The Ice,2008,1998,10,1989,19
Burnin' Up,2008,1998,10,2008,0
Bust It Baby Part 2,2008,1998,10,2008,0
Bust Your Windows,2008,1998,10,2008,0
Buzzin',2008,1998,10,2000,8
Bye Bye,2008,1998,10,2014,6
Calabria 2008,2008,1998,10,1980,28
Can't Be Tamed,2010,2000,10,2010,0
Can't Believe It,2008,1998,10,2008,0
Change,2008,1998,10,2005,3
Cleaning This Gun (Come On In Boy),2008,1998,10,2008,0
Closer,2008,1998,10,1980,28
Crush,2008,1998,10,2008,0
Cyanide,2008,1998,10,1999,9
Damaged,2008,1998,10,2008,0
Dey Know,2008,1998,10,2008,0
Disturbia,2008,1998,10,2008,0
Do You Believe Me Now,2008,1998,10,2008,0
Don't Stop Believin',2009,1999,10,2014,5
Don't Think I Don't Think About It,2008,1998,10,1980,28
Dream Big,2008,1998,10,2000,8
Drink In My Hand,2011,2001,10,2011,0
Emotional,2000,1990,10,1980,20
Empire State Of Mind,2009,1999,10,2009,0
Every Day,2008,1998,10,2008,0
Everybody Wants To Go To Heaven,2008,1998,10,1990,18
Everything To Me,2010,2000,10,1980,30
Face Down,2007,1997,10,1993,14
Fall For You,2008,1998,10,1980,28
Fancy,2010,2000,10,2010,0
Fearless,2008,1998,10,2008,0
Feedback,2008,1998,10,2011,3
Feels Like Tonight,2008,1998,10,1980,28
Forever,2008,1998,10,2008,0
Freeze,2008,1998,10,2008,0
Get On Your Boots,2009,1999,10,1980,29
Get Up,2008,1998,10,2008,0
Give It Up To Me,2009,1999,10,2006,3
Gonna Make You Sweat,1991,2001,10,1980,11
Gonna Make You Sweat,1991,2001,10,1980,11
Got Money,2008,1998,10,2008,0
Half Of My Heart,2009,1999,10,2001,8
Heartless,2009,1999,10,1980,29
Heaven Sent,2008,1998,10,1980,28
Hero/Heroine,2008,1998,10,1990,18
Hey Soul Sister,2010,2000,10,2009,1
Hit The Lights,2011,2001,10,2011,0
Home,2008,1998,10,1980,28
How Do You Sleep?,2009,1999,10,1980,29
How Do You Sleep?,2009,1999,10,2006,3
I Don't Care,2008,1998,10,2012,4
I Don't Want To Miss A Thing,2008,1998,10,1980,28
I Kissed A Girl,2008,1998,10,2008,0
I Luv Your Girl,2008,1998,10,2007,1
I Remember,2008,1998,10,2008,0
I Saw God Today,2008,1998,10,1981,27
I Still Haven't Found What I'm Looking For,2008,1998,10,2002,6
I Told You So,2007,1997,10,1981,26
I'd Come For You,2008,1998,10,1984,24
I'll Stand By You,2007,1997,10,1980,27
I'm Yours,2008,1998,10,2008,0
If I Ain't Got You,2004,1994,10,2005,1
If I Had Eyes,2008,1998,10,1980,28
If I Had You,2010,2000,10,2010,0
If I Were A Boy,2008,1998,10,2000,8
Imagine,2008,1998,10,2011,3
Impulsive,1990,2000,10,1990,0
In Love With A Girl,2008,1998,10,2008,0
It Happens,2009,1999,10,2009,0
It's America,2009,1999,10,2014,5
It's Not My Time,2008,1998,10,1995,13
Jaded,2001,1991,10,1980,21
John,2011,2001,10,2012,1
Just Fine,2008,1998,10,2015,7
Just Got Started Lovin' You,2008,1998,10,2008,0
Just Like Me,2009,1999,10,2002,7
Just The Way It Is Baby,1991,2001,10,2001,10
Kiss A Girl,2009,1999,10,2009,0
Kiss Me Thru The Phone,2009,1999,10,2011,2
Kush,2010,2000,10,2010,0
Last Name,2008,1998,10,2008,0
Leavin',2008,1998,10,2008,0
Light On,2008,1998,10,1980,28
Like A Prayer,2010,2000,10,1985,25
Lost In This Moment,2007,1997,10,1994,13
Love Drunk,2009,1999,10,2013,4
Love Like This,2008,1998,10,2007,1
Love Like Woe,2010,2000,10,2010,0
Love Lockdown,2008,1998,10,1980,28
Love Me,2009,1999,10,1980,29
Love Remains The Same,2008,1998,10,2008,0
Love Song,2008,1998,10,2007,1
Mad,2009,1999,10,1980,29
Marry The Night,2011,2001,10,2005,6
Meet Me Halfway,2009,1999,10,2009,0
Mercy,2008,1998,10,2008,0
My Life,2008,1998,10,2008,0
Never Wanted Nothing More,2007,1997,10,2007,0
New Soul,2008,1998,10,2009,1
No Air,2008,1998,10,1980,28
No One,2007,1997,10,1980,27
No Sleep,2011,2001,10,2011,0
One Step At A Time,2008,1998,10,2000,8
Only Time,2001,1991,10,1980,21
Our Song,2008,1998,10,2007,1
Over It,2007,1997,10,1980,27
Over You,2007,1997,10,1980,27
Paper Planes,2008,1998,10,2000,8
Paralyzer,2008,1998,10,2015,7
Play My Music,2008,1998,10,1996,12
Pocketful Of Sunshine,2008,1998,10,1980,28
Praying For Time,2008,1998,10,1981,27
Pretty Boy Swag,2010,2000,10,2011,1
Pushin' Me Away,2008,1998,10,1980,28
Put It On Ya,2009,1999,10,2009,0
Ready Set Don't Go,2008,1998,10,1980,28
Realize,2008,1998,10,1980,28
Right Above It,2010,2000,10,2010,0
Right Now (Na Na Na),2008,1998,10,1980,28
Right Round,2009,1999,10,2009,0
Right Thru Me,2010,2000,10,2011,1
Room At The Top,1990,2000,10,1990,0
Say,2008,1998,10,2008,0
Say Aah,2010,2000,10,2008,2
See You Again,2008,1998,10,2008,0
See You In My Nightmares,2008,1998,10,2001,7
Shake It,2008,1998,10,2008,0
She Never Cried In Front Of Me,2008,1998,10,2008,0
She's Like The Wind,2007,1997,10,1980,27
Should've Said No,2008,1998,10,2008,0
Shout To The Lord,2008,1998,10,2015,7
Sideways,2009,1999,10,1980,29
Small Town Southern Man,2008,1998,10,2001,7
Smooth Criminal,2001,1991,10,1980,21
Snow (Hey Oh),2007,1997,10,2006,1
So Small,2007,1997,10,2010,3
So What,2008,1998,10,1992,16
Stop And Stare,2008,1998,10,1980,28
Sugar,2009,1999,10,2009,0
Summertime,2008,1998,10,2015,7
Sweat,2011,2001,10,2011,0
Swing,2008,1998,10,1992,16
T-Shirt,2008,1998,10,2011,3
Take A Bow,2009,1999,10,2008,1
Take A Bow,2008,1998,10,2008,0
Take It Off,2010,2000,10,2010,0
Take You Down,2008,1998,10,1980,28
Take You There,2008,1998,10,1980,28
Talk Dirty,2014,2004,10,2014,0
Teenage Dream,2010,2000,10,2010,0
Teenage Dream,2010,2000,10,1980,30
Tender Lover,1990,2000,10,1989,1
The Boys Of Fall,2010,2000,10,2010,0
The House That Built Me,2010,2000,10,2010,0
The Time Of My Life,2008,1998,10,1980,28
Then,2009,1999,10,1980,29
Thinking Of You,2009,1999,10,2009,0
Titanium,2012,2002,10,2012,0
Titanium,2012,2002,10,2012,0
Tonight,2008,1998,10,1980,28
Upside Down,2006,1996,10,1980,26
Use Somebody,2009,1999,10,2006,3
Walk Away (Remember Me),2007,1997,10,2006,1
Walking In Memphis,1991,2001,10,1991,0
We're All In This Together,2006,1996,10,1990,16
What About Now,2008,1998,10,1980,28
What I've Done,2007,1997,10,1980,27
Whatcha Say,2009,1999,10,2009,0
Whatever It Takes,2008,1998,10,1980,28
When The Stars Go Blue,2006,1996,10,2006,0
When You Look Me In The Eyes,2008,1998,10,1980,28
Whip Appeal,1990,2000,10,1980,10
White Horse,2008,1998,10,2008,0
Who Dat Girl,2011,2001,10,2011,0
Who Says,2009,1999,10,1984,25
Why,2006,1996,10,1980,26
With You,2008,1998,10,2004,4
Won't Go Home Without You,2008,1998,10,2011,3
You Belong With Me,2009,1999,10,1980,29
You Found Me,2009,1999,10,1999,10
You Look Good In My Shirt,2008,1998,10,2008,0
You Rock My World,2001,1991,10,1980,21
3,2009,1998,11,1980,29
1234,2009,1998,11,1980,29
21 Guns,2009,1998,11,1980,29
3am,2009,1998,11,2004,5
About You Now,2009,1998,11,1980,29
Ain't I,2009,1998,11,1990,19
All My Life,2002,1991,11,1980,22
All The Above,2009,1998,11,2008,1
Already Gone,2009,1998,11,1980,29
Alright,2009,1998,11,2007,2
American Ride,2009,1998,11,2005,4
Back In Time,2012,2001,11,1991,21
Bad Romance,2010,1999,11,2014,4
Ball,2012,2001,11,2012,0
Battlefield,2009,1998,11,1980,29
Be On You,2009,1998,11,2007,2
Beautiful,2009,1998,11,2013,4
Beautiful Girls,2007,1996,11,1980,27
Beez In The Trap,2012,2001,11,2012,0
Best Days Of Your Life,2009,1998,11,2003,6
Best I Ever Had,2009,1998,11,2011,2
Big Green Tractor,2009,1998,11,2006,3
Birthday Sex,2009,1998,11,2010,1
Black And Yellow,2011,2000,11,2007,4
Blame It,2009,1998,11,2008,1
Bottoms Up,2010,1999,11,2011,1
Boyfriend #2,2009,1998,11,2008,1
Break Up,2009,1998,11,2009,0
Chasing Pavements,2009,1998,11,2001,8
Circus,2008,1997,11,2008,0
CoCo,2015,2004,11,2014,1
Come In With The Rain,2009,1998,11,1980,29
Consider Me Gone,2009,1998,11,1980,29
Country Girl (Shake It For Me),2011,2000,11,2011,0
Cowboy Casanova,2009,1998,11,2000,9
Cowgirls Don't Cry,2009,1998,11,1986,23
Crazier,2009,1998,11,1980,29
Crying Out For Me,2008,1997,11,2008,0
Day 'N' Nite,2009,1998,11,2009,0
Dead And Gone,2009,1998,11,2009,0
Decode,2009,1998,11,1983,26
Defying Gravity,2009,1998,11,2010,1
Diva,2009,1998,11,2007,2
Do I,2009,1998,11,1980,29
Don't Trust Me,2009,1998,11,2009,0
Don't Trust Me,2009,1998,11,2009,0
Down,2009,1998,11,1996,13
Down The Road,2009,1998,11,1991,18
Ego,2009,1998,11,1980,29
Empire State Of Mind,2010,1999,11,2009,1
Evacuate The Dancefloor,2009,1998,11,1991,18
Fallin' For You,2009,1998,11,1980,29
Favorite Girl,2009,1998,11,1980,29
Feel That Fire,2009,1998,11,1980,29
Fifteen,2009,1998,11,2009,0
Fire Burning,2009,1998,11,2009,0
Forever & Always,2009,1998,11,1980,29
Forget You,2010,1999,11,2010,0
Funny The Way It Is,2009,1998,11,1987,22
Get Back,2008,1997,11,1980,28
Gettin' You Home (The Black Dress Song),2009,1998,11,2009,0
Gives You Hell,2009,1998,11,1980,29
God Love Her,2009,1998,11,1982,27
Good Girls Go Bad,2009,1998,11,1980,29
Good Time,2008,1997,11,2008,0
Goodbye,2009,1998,11,2010,1
Goodbye,2009,1998,11,2009,0
Got Your Back,2010,1999,11,2010,0
Gotta Be Somebody,2008,1997,11,1980,28
Gotta Find You,2008,1997,11,1980,28
Halo,2009,1998,11,2009,0
Halo/Walking On Sunshine,2009,1998,11,2009,0
He Could Be The One,2009,1998,11,1980,29
Heartless,2009,1998,11,1980,29
Heaven,2002,1991,11,1980,22
Her Diamonds,2009,1998,11,2007,2
Here,2008,1997,11,1980,28
Here Comes Goodbye,2009,1998,11,1980,29
Here We Go Again,2009,1998,11,2005,4
Hey Daddy (Daddy's Home),2010,1999,11,2010,0
Hey Soul Sister,2010,1999,11,2009,1
Hold Up My Heart,2009,1998,11,1980,29
Home Sweet Home,2009,1998,11,1980,29
Hot Revolver,2009,1998,11,1981,28
Hotel Room Service,2009,1998,11,2007,2
I Can Transform Ya,2009,1998,11,2009,0
I Cry,2012,2001,11,2012,0
I Do Not Hook Up,2009,1998,11,1980,29
I Don't Wanna Be In Love (Dance Floor Anthem),2008,1997,11,1997,11
I Got A Thang 4 Ya!,1993,2004,11,1980,13
I Hate This Part,2009,1998,11,1985,24
I Like It,2010,1999,11,2010,0
I Still Miss You,2008,1997,11,2008,0
I Told You So,2009,1998,11,2009,0
I Will Not Bow,2009,1998,11,1980,29
I'm Back,2010,1999,11,1994,16
I'm On One,2011,2000,11,2011,0
Ice Ice Baby,1990,2001,11,1980,10
If Today Was Your Last Day,2009,1998,11,1990,19
If U Seek Amy,2009,1998,11,1980,29
If We Ever Meet Again,2010,1999,11,1980,30
Into The Night,2008,1997,11,1980,28
It Won't Be Like This For Long,2009,1998,11,2009,0
It's My Life/Confessions Part II,2009,1998,11,1980,29
Jump Then Fall,2009,1998,11,2005,4
Just A Dream,2010,1999,11,2003,7
Knock You Down,2009,1998,11,2009,0
Lean On Me,2009,1998,11,1998,11
Life In A Northern Town,2008,1997,11,1988,20
Like You'll Never See Me Again,2008,1997,11,1980,28
Live Like We're Dying,2010,1999,11,2009,1
Look At Me Now,2011,2000,11,2011,0
Lost!,2009,1998,11,1980,29
Love Is A Beautiful Thing,2008,1997,11,2008,0
Love On Top,2011,2000,11,1980,31
Love Sex Magic,2009,1998,11,2009,0
Love Story,2009,1998,11,2013,4
Love Story,2009,1998,11,2013,4
Lovebug,2009,1998,11,1994,15
Man In The Mirror,2011,2000,11,2010,1
Marvin & Chardonnay,2011,2000,11,2011,0
Mistletoe,2011,2000,11,2011,0
Money To Blow,2010,1999,11,2009,1
My First Kiss,2010,1999,11,1980,30
My Life Would Suck Without You,2009,1998,11,2012,3
Nasty,2015,2004,11,2004,11
Never Say Never,2009,1998,11,1980,29
No Lie,2012,2001,11,2012,0
No Such Thing,2002,1991,11,1980,22
No Surprise,2009,1998,11,2009,0
Note To God,2009,1998,11,1980,29
Nude,2008,1997,11,1980,28
Obsessed,2009,1998,11,2009,0
One More Drink,2009,1998,11,2008,1
Out Last Night,2009,1998,11,1998,11
Over The Rainbow,2010,1999,11,2010,0
Pants On The Ground,2010,1999,11,1999,11
Paparazzi,2009,1998,11,2009,0
Papers,2009,1998,11,2006,3
Paranoid,2009,1998,11,2002,7
People Are Crazy,2009,1998,11,2009,0
Please Don't Leave Me,2009,1998,11,2009,0
Pop Champange,2009,1998,11,1998,11
Pray For You,2010,1999,11,2005,5
Pretty Good At Drinkin' Beer,2010,1999,11,2010,0
Prom Queen,2009,1998,11,2010,1
Pumped Up Kicks,2011,2000,11,2011,0
Racks,2011,2000,11,2011,0
Redneck Crazy,2013,2002,11,1980,33
Rehab,2009,1998,11,2009,0
Remember Me,2009,1998,11,2003,6
Rockin' That Thang,2009,1998,11,2005,4
Run This Town,2009,1998,11,2009,0
S&M,2011,2000,11,2011,0
Send It On,2009,1998,11,1980,29
Seventeen Forever,2009,1998,11,1980,29
Shattered (Turn The Car Around),2008,1997,11,2008,0
She Wouldn't Be Gone,2009,1998,11,2009,0
She's Country,2009,1998,11,2009,0
Singing In The Rain/Umbrella,2010,1999,11,2007,3
Small Town USA,2009,1998,11,2009,0
Sober,2009,1998,11,2013,4
Somebody To Love,2009,1998,11,2010,1
Sorry,2008,1997,11,1980,28
Spotlight,2008,1997,11,2008,0
Standing Still,2002,1991,11,1980,22
Stuck Like Glue,2010,1999,11,2011,1
Suffocate,2008,1997,11,2007,1
The Boomin' System,1990,2001,11,1990,0
The Christmas Song (Merry Christmas To You),2014,2003,11,1994,20
The Story Of Us,2010,1999,11,1992,18
There Goes My Baby,2010,1999,11,2010,0
This Afternoon,2010,1999,11,2010,0
Tic-Tac-Toe,1990,2001,11,1990,0
Time For Miracles,2009,1998,11,1980,29
Toes,2009,1998,11,2009,0
Turn My Swag On,2009,1998,11,2009,0
Turnin Me On,2009,1998,11,2009,0
Untouched,2009,1998,11,2008,1
Wanted,2009,1998,11,1980,29
Watching Airplanes,2008,1997,11,2009,1
Welcome To The Future,2009,1998,11,2003,6
What's My Name?,2010,1999,11,2011,1
Whatever It Is,2009,1998,11,2009,0
When I Look At You,2010,1999,11,1990,20
White Liar,2009,1998,11,2009,0
White Walls,2013,2002,11,2013,0
White Walls,2013,2002,11,2013,0
Wiggle It,1990,2001,11,1995,5
You Are The Music In Me,2007,1996,11,1980,27
You Lie,2011,2000,11,2011,0
Young Wild & Free,2011,2000,11,2011,0
(I've Had) The Time Of My Life,2010,1998,12,2010,0
2012 (It Ain't The End),2010,1998,12,1988,22
A Little More Country Than That,2010,1998,12,1980,30
A Year Without Rain,2010,1998,12,1990,20
According To You,2010,1998,12,1980,30
Ain't Back Yet,2010,1998,12,2003,7
Airplanes,2010,1998,12,1994,16
All About Tonight,2010,1998,12,2001,9
All I Do Is Win,2010,1998,12,2005,5
All The Right Moves,2010,1998,12,1980,30
All The Way Turnt Up,2010,1998,12,2013,3
Animal,2010,1998,12,1980,30
Anything Like Me,2010,1998,12,2005,5
As She's Walking Away,2010,1998,12,1991,19
Baby,2010,1998,12,1980,30
Back To December,2010,1998,12,1982,28
Bandz A Make Her Dance,2012,2000,12,2008,4
Beamer Benz Or Bentley,2010,1998,12,2005,5
Beautiful Day,2010,1998,12,2002,8
BedRock,2010,1998,12,2004,6
BedRock,2010,1998,12,2004,6
Better In Time,2008,1996,12,1980,28
Big Yellow Taxi,2003,1991,12,1980,23
Billionaire,2010,1998,12,2007,3
Billionaire,2010,1998,12,2007,3
Blah Blah Blah,2010,1998,12,2009,1
Booty Wurk (One Cheek At A Time),2011,1999,12,2004,7
Break Your Heart,2010,1998,12,2010,0
Breakeven,2010,1998,12,2010,0
Bulletproof,2010,1998,12,2010,0
California Gurls,2010,1998,12,2010,0
California King Bed,2011,1999,12,1980,31
Carry Out,2010,1998,12,2009,1
Christmas Lights,2010,1998,12,2012,2
Club Can't Handle Me,2010,1998,12,2010,0
Come Back Song,2010,1998,12,1999,11
Cooler Than Me,2010,1998,12,2010,0
Country Boy,2009,1997,12,1999,10
Crazy Kids,2013,2001,12,2013,0
DJ Got Us Fallin' In Love,2010,1998,12,1992,18
Deuces,2010,1998,12,2010,0
Do You Remember,2010,1998,12,2009,1
Dog Days Are Over,2010,1998,12,1983,27
Dog Days Are Over,2010,1998,12,1983,27
Don't Forget,2009,1997,12,1980,29
Don't Go Breaking My Heart,2010,1998,12,2010,0
Drop The World,2010,1998,12,2010,0
Dynamite,2010,1998,12,2010,0
Eenie Meenie,2010,1998,12,2012,2
Erase Me,2010,1998,12,2013,3
F**k You (Forget You),2011,1999,12,2010,1
Faithfully,2010,1998,12,2010,0
Fall For Your Type,2011,1999,12,2002,9
Farmer's Daughter,2010,1998,12,2004,6
Find Your Love,2010,1998,12,1980,30
Fireflies,2009,1997,12,2009,0
Firework,2010,1998,12,2012,2
Free,2010,1998,12,2001,9
Gettin' Over You,2010,1998,12,2008,2
Gimmie That Girl,2010,1998,12,2010,0
Give Me Everything,2011,1999,12,2011,0
Give Me Everything,2011,1999,12,2011,0
Gives You Hell,2010,1998,12,2010,0
Glitter In The Air,2010,1998,12,2001,9
Halfway Gone,2010,1998,12,2004,6
Hallelujah,2010,1998,12,2010,0
Hallelujah,2010,1998,12,2010,0
Happy,2009,1997,12,1980,29
Haven't Met You Yet,2010,1998,12,2004,6
Heartbreak Warfare,2010,1998,12,2009,1
Hello,2010,1998,12,2010,0
Hello,2011,1999,12,1980,31
Higher,2011,1999,12,2011,0
Highway 20 Ride,2010,1998,12,2002,8
Honey Bee,2011,1999,12,2005,6
I Dreamed A Dream,2010,1998,12,2001,9
I Invented Sex,2010,1998,12,2003,7
I Never Told You,2010,1998,12,1980,30
I Run To You,2009,1997,12,2006,3
I Want To Hold Your Hand,2010,1998,12,2008,2
I'm Alive,2009,1997,12,2009,0
If Heaven Wasn't So Far Away,2011,1999,12,2002,9
If It's Love,2010,1998,12,2002,8
If You Only Knew,2010,1998,12,2009,1
Imma Be,2010,1998,12,2009,1
Impossible,2010,1998,12,2002,8
Innocent,2010,1998,12,1980,30
Intuition,2003,1991,12,1980,23
It Girl,2011,1999,12,2011,0
It Kills Me,2010,1998,12,1980,30
Jessie's Girl,2010,1998,12,2013,3
Just The Way You Are,2010,1998,12,2010,0
Just The Way You Are,2010,1998,12,2010,0
King Of Anything,2010,1998,12,2004,6
Life After You,2010,1998,12,1980,30
Like My Mother Does,2011,1999,12,2000,11
Listen,2010,1998,12,1980,30
Live My Life,2012,2000,12,2011,1
Lolly,2013,2001,12,2013,0
Love The Way You Lie,2010,1998,12,2010,0
Lover Lover,2010,1998,12,1980,30
Lucky,2009,1997,12,1980,29
Mad World,2009,1997,12,1980,29
Marry Me,2011,1999,12,1980,31
Marry You,2010,1998,12,2010,0
Marvins Room,2011,1999,12,2011,0
Mean,2010,1998,12,2010,0
Memories,2010,1998,12,1980,30
Mine,2010,1998,12,2010,0
Misery,2010,1998,12,2010,0
My Hitta,2013,2001,12,2015,2
Naturally,2010,1998,12,1985,25
Need You Now,2010,1998,12,1980,30
Never Let You Go,2010,1998,12,2013,3
Never Say Never,2011,1999,12,1996,15
New Divide,2009,1997,12,2009,0
No Boundaries,2009,1997,12,2011,2
Not Afraid,2010,1998,12,2010,0
Not Myself Tonight,2010,1998,12,2006,4
Nothin' On You,2010,1998,12,2010,0
On To The Next One,2010,1998,12,2010,0
One Time,2010,1998,12,2009,1
Only Girl (In The World),2010,1998,12,1980,30
Only The Good Die Young,2010,1998,12,2005,5
Only You Can Love Me This Way,2009,1997,12,1980,29
Or Nah,2014,2002,12,2014,0
Over,2010,1998,12,2010,0
Permanent,2009,1997,12,1980,29
Please Don't Go,2010,1998,12,1980,30
Pontoon,2012,2000,12,2012,0
Pretty Girl Rock,2011,1999,12,2008,3
Radioactive,2010,1998,12,1985,25
Raise Your Glass,2010,1998,12,2010,0
Replay,2010,1998,12,2009,1
Ride,2010,1998,12,2010,0
Ridin' Solo,2010,1998,12,1980,30
River Deep Mountain High,2010,1998,12,1984,26
Rock That Body,2010,1998,12,2010,0
Rude Boy,2010,1998,12,2010,0
Rumour Has It/Someone Like You,2011,1999,12,1987,24
Russian Roulette,2009,1997,12,1980,29
Say Something,2010,1998,12,2010,0
Scream & Shout,2013,2001,12,2013,0
Second Chance,2009,1997,12,2009,0
Secrets,2010,1998,12,2010,0
Sexy Chick,2010,1998,12,1980,30
Skyscraper,2011,1999,12,1986,25
Smooth Criminal,2012,2000,12,1996,16
Somebody To Love,2010,1998,12,1980,30
Sparks Fly,2010,1998,12,2010,0
Speak Now,2010,1998,12,2010,0
Start Me Up/Livin' On A Prayer,2010,1998,12,2010,0
Stop! In The Name Of Love/Free Your Mind,2010,1998,12,2010,0
Stranded (Haiti Mon Amour),2010,1998,12,2011,1
Superman,2011,1999,12,2007,4
Superstar,2009,1997,12,1994,15
Sweet Caroline,2009,1997,12,2009,0
Sweet Thing,2009,1997,12,2012,3
Temporary Home,2010,1998,12,1980,30
The Man I Want To Be,2010,1998,12,1980,30
The Only Exception,2010,1998,12,2010,0
The Only Exception,2010,1998,12,2010,0
The Other Side Of The Door,2009,1997,12,1991,18
The Show Goes On,2011,1999,12,2011,0
The Time (Dirty Bit),2010,1998,12,2010,0
The Truth,2010,1998,12,1980,30
Today Was A Fairytale,2010,1998,12,2000,10
Tongue Tied,2012,2000,12,2000,12
Total Eclipse Of The Heart,2010,1998,12,2010,0
Touchin On My,2010,1998,12,1980,30
Toxic,2010,1998,12,2010,0
Try Sleeping With A Broken Heart,2010,1998,12,1980,30
Two Is Better Than One,2010,1998,12,1980,30
Two is Better Than One,2010,1998,12,1980,30
Type Of Way,2013,2001,12,2014,1
U Smile,2010,1998,12,1980,30
UP!,2012,2000,12,2012,0
UP!,2012,2000,12,2012,0
Un-Thinkable (I'm Ready),2010,1998,12,2010,0
Undo It,2010,1998,12,1980,30
Untouchable,2009,1997,12,1993,16
Va Va Voom,2012,2000,12,2012,0
Water,2010,1998,12,1998,12
Where It's At (Yep Yep),2014,2002,12,2009,5
Why Don't We Just Dance,2010,1998,12,2006,4
Why Wait,2010,1998,12,2010,0
Why Ya Wanna,2012,2000,12,2002,10
Wide Awake,2012,2000,12,2005,7
Yeah 3X,2011,1999,12,2007,4
You And Your Heart,2010,1998,12,1980,30
Young Wild & Free,2012,2000,12,2011,1
(It) Feels So Good,2011,1998,13,1989,22
5 O'Clock,2011,1998,13,2011,0
5-1-5-0,2012,1999,13,1992,20
6 Foot 7 Foot,2011,1998,13,2012,1
A Little Bit Stronger,2011,1998,13,1980,31
Alejandro,2010,1997,13,2001,9
All Of The Lights,2011,1998,13,2006,5
All Your Life,2011,1998,13,2007,4
Am I The Only One,2011,1998,13,2002,9
American Honey,2010,1997,13,1980,30
Angel Eyes,2012,1999,13,1980,32
Are You Gonna Kiss Me Or Not,2011,1998,13,1980,31
Aston Martin Music,2011,1998,13,2011,0
Baby,2011,1998,13,2010,1
Backseat,2011,1998,13,2011,0
Baggage Claim,2011,1998,13,2011,0
Bailando,2014,2001,13,2004,10
Barefoot Blue Jean Night,2011,1998,13,2010,1
Beautiful People,2011,1998,13,1980,31
Best Love Song,2011,1998,13,2012,1
Best Thing I Never Had,2011,1998,13,2014,3
Better With The Lights Off,2011,1998,13,2008,3
Bills Bills Bills,2011,1998,13,2005,6
Birthday Song,2012,1999,13,2008,4
Blow,2011,1998,13,1990,21
Bo$$,2014,2001,13,2010,4
Born This Way,2011,1998,13,1980,31
Bow Chicka Wow Wow,2011,1998,13,2011,0
Call Me Maybe,2012,1999,13,1980,32
Clique,2012,1999,13,2012,0
Colder Weather,2011,1998,13,2011,0
Coming Home,2011,1998,13,2010,1
Country Must Be Country Wide,2011,1998,13,2013,2
Crawling Back To You,2011,1998,13,1980,31
Crazy Girl,2011,1998,13,2003,8
Dirt Road Anthem,2011,1998,13,2011,0
Dirty Dancer,2011,1998,13,1993,18
Don't You Wanna Stay,2011,1998,13,1980,31
Don't You Want Me,2011,1998,13,2010,1
Down On Me,2011,1998,13,2011,0
Dream On,2010,1997,13,1980,30
Easy,2011,1998,13,2011,0
Every Teardrop Is A Waterfall,2011,1998,13,2011,0
F**kin Problems,2012,1999,13,2012,0
F**kin' Perfect,2011,1998,13,2011,0
F**kin' Perfect,2011,1998,13,2011,0
Feel Like A Rock Star,2012,1999,13,1980,32
Finally Found You,2012,1999,13,2013,1
Firework,2011,1998,13,2010,1
For The First Time,2011,1998,13,1982,29
Freak The Freak Out,2011,1998,13,2010,1
Get It Right,2011,1998,13,2010,1
Go Your Own Way,2011,1998,13,2010,1
Good Girl,2012,1999,13,1980,32
Good Life,2011,1998,13,2011,0
Hair,2011,1998,13,1983,28
Hall Of Fame,2013,2000,13,2012,1
Happy Days Are Here Again/Get Happy,2010,1997,13,2010,0
Headlines,2011,1998,13,2011,0
Here For A Good Time,2011,1998,13,2003,8
Hey Baby (Drop IT To The Floor),2011,1998,13,2007,4
Hey Baby (Drop It To The Floor),2011,1998,13,2007,4
Hold It Against Me,2011,1998,13,1980,31
Hold My Hand,2011,1998,13,2008,3
How Country Feels,2013,2000,13,2013,0
How To Love,2011,1998,13,2011,0
Hy Hitta,2014,2001,13,2013,1
I Can Only Imagine,2012,1999,13,2012,0
I Do,2011,1998,13,1980,31
I Don't Wanna Know,2004,1991,13,1980,24
I Don't Want This Night To End,2011,1998,13,2011,0
I Feel Pretty/Unpretty,2011,1998,13,2010,1
I Just Had Sex,2011,1998,13,2010,1
I Love You This Big,2011,1998,13,2011,0
I Need A Doctor,2011,1998,13,2011,0
I Will Wait,2013,2000,13,2003,10
I Won't Let Go,2011,1998,13,1980,31
I'm Into You,2011,1998,13,2015,4
If I Die Young,2011,1998,13,2010,1
If This Was A Movie,2011,1998,13,2002,9
In The Dark,2011,1998,13,2011,0
International Love,2012,1999,13,2011,1
Inventing Shadows,2011,1998,13,1992,19
It Will Rain,2011,1998,13,1993,18
Jar Of Hearts,2011,1998,13,1980,31
Jar Of Hearts,2011,1998,13,2010,1
Just A Kiss,2011,1998,13,1980,31
Keep Me In Mind,2011,1998,13,1980,31
Knee Deep,2011,1998,13,1999,12
Landslide,2011,1998,13,2002,9
Last Friday Night (T.G.I.F.),2011,1998,13,1990,21
Lean On Me,2010,1997,13,2005,5
Let Me Down Easy,2011,1998,13,1980,31
Lily Was Here,1991,2004,13,1980,11
Little Lion Man,2011,1998,13,2010,1
Long Hot Summer,2011,1998,13,2012,1
Loser Like Me,2011,1998,13,1980,31
Loyal,2014,2001,13,2010,4
Loyal,2014,2001,13,2010,4
Loyal,2014,2001,13,2010,4
Lucky,2010,1997,13,2010,0
Mirror,2011,1998,13,2011,0
Monster,2011,1998,13,2015,4
More,2011,1998,13,2011,0
Moves Like Jagger,2011,1998,13,2011,0
Mr. Know It All,2011,1998,13,1980,31
My Homies Still,2012,1999,13,2012,0
My Life,2012,1999,13,2010,2
Nasty Freestyle,2015,2002,13,2015,0
Next To Me,2013,2000,13,1987,26
Next To You,2011,1998,13,1980,31
Old Alabama,2011,1998,13,2011,0
On The Floor,2011,1998,13,2011,0
Ours,2011,1998,13,2011,0
Out Of My Head,2011,1998,13,2002,9
Poetic Justice,2013,2000,13,2013,0
Power Of Love/Love Power,1991,2004,13,1980,11
Pretty Girls,2011,1998,13,2011,0
Price Tag,2011,1998,13,2011,0
Price Tag,2011,1998,13,2011,0
Remind Me,2011,1998,13,2011,0
Rhythm Of Love,2011,1998,13,2011,0
Right There,2011,1998,13,1998,13
Rolling In The Deep,2011,1998,13,2011,0
Rolling In The Deep,2011,1998,13,2010,1
Round & Round,2010,1997,13,2010,0
Rumour Has It,2012,1999,13,1987,25
Run The World (Girls),2011,1998,13,2011,0
Scream,2012,1999,13,1987,25
Scream & Shout,2012,1999,13,2012,0
September,2010,1997,13,1980,30
She Ain't You,2011,1998,13,1980,31
She Will,2011,1998,13,2011,0
Silly Love Songs,2011,1998,13,2010,1
Sing,2011,1998,13,2010,1
Smile,2010,1997,13,2005,5
Some Nights,2012,1999,13,2012,0
Someone Like You,2011,1998,13,1980,31
Somethin' Bad,2014,2001,13,2014,0
Somewhere With You,2011,1998,13,1980,31
Southern Girl,2013,2000,13,2013,0
Started From The Bottom,2013,2000,13,1980,33
Stereo Hearts,2011,1998,13,2011,0
Stereo Love,2011,1998,13,1980,31
Stereo Love,2011,1998,13,1983,28
Stitch By Stitch,2011,1998,13,2010,1
Stronger (What Doesn't Kill You),2012,1999,13,1980,32
Stupid Boy,2012,1999,13,1980,32
Super Bass,2011,1998,13,2011,0
Take A Back Road,2011,1998,13,2011,0
Take Over Control,2011,1998,13,2011,0
The Cave,2011,1998,13,1992,19
The Climb,2009,1996,13,1980,29
The Climb,2009,1996,13,1980,29
The Edge Of Glory,2011,1998,13,1980,31
Thinkin Bout You,2012,1999,13,2013,1
Till The World Ends,2011,1998,13,2009,2
Tomorrow,2011,1998,13,1980,31
We Are Young,2011,1998,13,2010,1
What The Hell,2011,1998,13,1980,31
When I Get You Alone,2011,1998,13,2010,1
White Iverson,2015,2002,13,2004,11
Who Says,2011,1998,13,2011,0
Wiggle,2014,2001,13,2014,0
Work B**ch!,2013,2000,13,1997,16
You,2012,1999,13,2012,0
You And Tequila,2011,1998,13,2011,0
You Da One,2011,1998,13,1980,31
Young Forever,2010,1997,13,2009,1
(Kissed You) Good Night,2012,1998,14,1980,32
2 On,2014,2000,14,2000,14
2 Reasons,2012,1998,14,2000,12
50 Ways To Say Goodbye,2012,1998,14,2004,8
A Thousand Years,2012,1998,14,1980,32
A Woman Like You,2012,1998,14,1998,14
Adorn,2012,1998,14,2000,12
All Around The World,2012,1998,14,2007,5
All Gold Everything,2013,1999,14,2012,1
Alone With You,2012,1998,14,1980,32
Animals,2014,2000,14,1980,34
Anything Could Happen,2012,1998,14,1984,28
As Long As You Love Me,2012,1998,14,1999,13
Ass Back Home,2012,1998,14,2007,5
Ass Back Home,2012,1998,14,2007,5
Begin Again,2012,1998,14,1980,32
Birthday Cake,2012,1998,14,2012,0
Blackbird,2011,1997,14,2010,1
Blackout,2012,1998,14,2012,0
Blackout,2012,1998,14,2010,2
Blow Me (One Last Kiss),2012,1998,14,2002,10
Blown Away,2012,1998,14,1980,32
Blue Orchid,2005,1991,14,1980,25
Both Of Us,2012,1998,14,1999,13
Boyfriend,2012,1998,14,2013,1
Brighter Than The Sun,2012,1998,14,2012,0
Brokenhearted,2012,1998,14,2012,0
Burn It Down,2012,1998,14,2004,8
Buy Me A Boat,2015,2001,14,2015,0
Climax,2012,1998,14,2012,0
Come Over,2012,1998,14,2014,2
Cowboys And Angels,2012,1998,14,1980,32
Cruise,2012,1998,14,2012,0
Cruise,2012,1998,14,2012,0
Dance Again,2012,1998,14,2010,2
Dancin' Away With My Heart,2012,1998,14,1980,32
Dark Side,2012,1998,14,2012,0
Did It On'em,2011,1997,14,2011,0
Die In Your Arms,2012,1998,14,1980,32
Die Young,2012,1998,14,1992,20
Domino,2012,1998,14,2012,0
Don't Wake Me Up,2012,1998,14,1984,28
Don't Wanna Go Home,2011,1997,14,2003,8
Drank In My Cup,2012,1998,14,2012,0
Drink On It,2012,1998,14,2010,2
Drive By,2012,1998,14,2012,0
Eyes Open,2012,1998,14,1994,18
F**kin Problems,2013,1999,14,2012,1
Fastest Girl In Town,2012,1998,14,2000,12
Feel Again,2012,1998,14,2012,0
Feel This Moment,2013,1999,14,2013,0
Fly Over States,2012,1998,14,2012,0
Friday Night,2014,2000,14,2014,0
Get Me Bodied,2013,1999,14,2013,0
Get Your Shine On,2013,1999,14,2013,0
Get Your Shine On,2013,1999,14,2013,0
Girl On Fire,2012,1998,14,1980,32
Give Me All Your Luvin',2012,1998,14,2012,0
Give Your Heart A Break,2012,1998,14,2012,0
Glad You Came,2012,1998,14,1980,32
God Gave Me You,2011,1997,14,2003,8
Good Time,2012,1998,14,2012,0
Good Time,2012,1998,14,2012,0
Goodbye In Her Eyes,2012,1998,14,2012,0
Grenade,2011,1997,14,1997,14
Hard To Love,2012,1998,14,2012,0
Heart Like Mine,2011,1997,14,1980,31
Heartbeat,2012,1998,14,1989,23
Ho Hey,2012,1998,14,2012,0
Hold On We're Going Home,2013,1999,14,1980,33
Home,2012,1998,14,1980,32
I Don't Like It I Love It,2015,2001,14,2015,0
I Drive Your Truck,2013,1999,14,1980,33
I Like It Like That,2012,1998,14,2011,1
I Wanna Dance With Somebody,2012,1998,14,1980,32
I Won't Give Up,2012,1998,14,2012,0
It Goes Like This,2013,1999,14,1980,33
Kiss Tomorrow Goodbye,2012,1998,14,1980,32
Let Me Love You (Until You Learn To Love Yourself),2012,1998,14,2012,0
Let's Go,2012,1998,14,2011,1
Lights,2012,1998,14,2006,6
Little Drummer Boy,2013,1999,14,1992,21
Live While We're Young,2012,1998,14,2009,3
Locked Out Of Heaven,2012,1998,14,1980,32
Lotus Flower Bomb,2011,1997,14,2011,0
Love More,2013,1999,14,2013,0
Mama's Broken Heart,2013,1999,14,2013,0
Motivation,2011,1997,14,2011,0
My Hiita,2014,2000,14,2008,6
No Hurry,2012,1998,14,2004,8
No Mediocre,2014,2000,14,2014,0
No Type,2014,2000,14,2013,1
Not Over You,2012,1998,14,2011,1
Nothing,2011,1997,14,2000,11
One More Night,2012,1998,14,2009,3
Over,2012,1998,14,1980,32
Over You,2012,1998,14,2012,0
Over You,2012,1998,14,2012,0
Payphone,2012,1998,14,2006,6
Pretending,2011,1997,14,2010,1
Problem,2014,2000,14,2014,0
Radioactive,2013,1999,14,1989,24
Recovery,2013,1999,14,2003,10
Red,2012,1998,14,2012,0
Ronan,2012,1998,14,2008,4
Runaway Baby,2012,1998,14,2003,9
Runnin' Outta Moonlight,2013,1999,14,2011,2
Safe And Sound,2013,1999,14,1993,20
Say Something,2013,1999,14,1980,33
Say Something,2013,1999,14,1980,33
Set Fire To The Rain,2012,1998,14,1980,32
Settle Down,2012,1998,14,1995,17
Shadow Days,2012,1998,14,1980,32
Shake It Off,2014,2000,14,2014,0
Skyfall,2012,1998,14,2012,0
Slow Down,2013,1999,14,2011,2
Slow Motion,2015,2001,14,2008,7
Somebody That I Used To Know,2012,1998,14,2012,0
Somebody That I Used To Know,2012,1998,14,2012,0
Somethin' 'Bout A Truck,2012,1998,14,2012,0
Somewhere Only We Know,2011,1997,14,2010,1
Springsteen,2012,1998,14,2012,0
State Of Grace,2012,1998,14,2002,10
Stuck On A Feeling,2015,2001,14,2015,0
Sunny And 75,2013,1999,14,1996,17
Sure Thing,2011,1997,14,2011,0
Sweet Dreams,2009,1995,14,1980,29
Swimming Pools (Drank),2012,1998,14,2013,1
Take A Little Ride,2012,1998,14,2012,0
Take Care,2012,1998,14,2011,1
That's My Kind Of Night,2013,1999,14,2013,0
The A Team,2013,1999,14,2012,1
The A Team,2013,1999,14,2012,1
The One That Got Away,2012,1998,14,2005,7
The Other Side,2013,1999,14,1980,33
Thriller/Heads Will Roll,2011,1997,14,2010,1
Time Is Love,2012,1998,14,1980,32
Tonight Is The Night,2012,1998,14,2012,0
Too Close,2012,1998,14,1980,32
Try,2012,1998,14,2005,7
Turn Me On,2012,1998,14,2011,1
Turn On The Lights,2012,1998,14,1991,21
Unconditionally,2013,1999,14,2013,0
Under Pressure,2005,1991,14,1980,25
Waiting For The End,2011,1997,14,2011,0
Want U Back,2012,1998,14,2006,6
Wanted,2012,1998,14,1980,32
Wanted You More,2011,1997,14,1980,31
Wasted,2014,2000,14,2000,14
We Are Never Ever Getting Back Together,2012,1998,14,2006,6
We Are Young,2012,1998,14,1980,32
We Are Young,2012,1998,14,1980,32
We Dem Boyz,2014,2000,14,2011,3
We Found Love,2011,1997,14,1980,31
We Own It (Fast & Furious),2013,1999,14,2013,0
We Owned The Night,2011,1997,14,1980,31
We Run The Night,2012,1998,14,1982,30
Welcome To New York,2014,2000,14,1994,20
When We Stand Together,2011,1997,14,2011,0
Whistle,2012,1998,14,2012,0
You And I,2011,1997,14,1992,19
You're So Beautiful,2015,2001,14,1980,35
Young Girls,2014,2000,14,2012,2
Your Body,2012,1998,14,1980,32
22,2013,1998,15,2010,3
23,2013,1998,15,1993,20
23,2013,1998,15,1993,20
23,2013,1998,15,1993,20
#Beautiful,2013,1998,15,1980,33
Alive,2013,1998,15,1980,33
All Bad,2013,1998,15,2007,6
All I Want For Christmas Is You,2013,1998,15,1985,28
All Me,2013,1998,15,2010,3
All Of Me,2014,1999,15,1999,15
All That Matters,2013,1998,15,1980,33
Antidote,2015,2000,15,1998,17
Anywhere With You,2013,1998,15,2012,1
Applause,2013,1998,15,1995,18
Aw Naw,2013,1998,15,2007,6
Baby I,2013,1998,15,1980,33
Bad,2013,1998,15,2008,5
Bad,2013,1998,15,2008,5
Beat This Summer,2013,1998,15,1982,31
Beauty And A Beat,2013,1998,15,2010,3
Beneath Your Beautiful,2013,1998,15,1980,33
Berzerk,2013,1998,15,2009,4
Best Song Ever,2013,1998,15,2013,0
Better Dig Two,2013,1998,15,1996,17
Beware,2013,1998,15,2015,2
Bitch Don't Kill My Vibe,2013,1998,15,2012,1
Blurred Lines,2013,1998,15,2013,0
Body Party,2013,1998,15,1980,33
Boys 'Round Here,2013,1998,15,2010,3
Boys 'Round Here,2013,1998,15,2010,3
Burn,2013,1998,15,1980,33
Can't Hold Us,2013,1998,15,2013,0
Carolina,2013,1998,15,1980,33
Carry On,2013,1998,15,1980,33
Catch My Breath,2013,1998,15,2012,1
Chasing The Sun,2012,1997,15,1980,32
Clarity,2013,1998,15,2013,0
Clouds,2013,1998,15,2002,11
Come & Get It,2013,1998,15,2013,0
Confident,2013,1998,15,2002,11
Cool Kids,2014,1999,15,1980,34
Cop Car,2014,1999,15,1991,23
Crash My Party,2013,1998,15,1980,33
Crooked Smile,2013,1998,15,2013,0
Cruise (Remix),2013,1998,15,2012,1
Cups,2013,1998,15,1980,33
DONE,2013,1998,15,2013,0
DONE.,2013,1998,15,2013,0
Dark Horse,2013,1998,15,2013,0
Daylight,2013,1998,15,2013,0
Demons,2013,1998,15,2013,0
Diamonds,2012,1997,15,2012,0
Diana,2013,1998,15,1980,33
Dirt,2014,1999,15,2014,0
Do What U Want,2013,1998,15,2009,4
Doin' What She Likes,2014,1999,15,2014,0
Don't Stop,2014,1999,15,1980,34
Don't Tell 'Em,2014,1999,15,2014,0
Don't Ya,2013,1998,15,1980,33
Dope,2013,1998,15,1990,23
Downtown,2013,1998,15,2013,0
Drunk Last Night,2013,1998,15,1980,33
Drunk On You,2012,1997,15,2008,4
Even If It Breaks Your Heart,2012,1997,15,2014,2
Every Storm (Runs Out Of Rain),2013,1998,15,1980,33
Everybody Talks,2012,1997,15,1998,14
Everything Has Changed,2013,1998,15,1980,33
Fine China,2013,1998,15,2013,0
Get Lucky,2013,1998,15,2006,7
Get Me Some Of That,2014,1999,15,2014,0
Girl On Fire,2013,1998,15,1980,33
Give It 2 U,2013,1998,15,2010,3
Give It All We Got Tonight,2013,1998,15,1980,33
Good Feeling,2012,1997,15,2011,1
Good Felling,2012,1997,15,2011,1
Gorilla,2013,1998,15,2013,0
Habits (Stay High),2014,1999,15,2014,0
Hallelujah,2013,1998,15,2010,3
Heart Attack,2013,1998,15,2013,0
Heart Attack,2012,1997,15,2012,0
Heartbreaker,2013,1998,15,1980,33
Hey Girl,2013,1998,15,1980,33
Hey Mama,2015,2000,15,2015,0
Hey Porsche,2013,1998,15,2004,9
Hey Pretty Girl,2013,1998,15,1980,33
Highway Don't Care,2013,1998,15,1980,33
Highway Don't Care,2013,1998,15,1980,33
Hit The Quan,2015,2000,15,2014,1
Hit The Quan,2015,2000,15,2014,1
Hit The Quan,2015,2000,15,2014,1
Hold Tight,2013,1998,15,2008,5
Holy Grail,2013,1998,15,2013,0
I Don't F**k With You,2014,1999,15,2014,0
I Hold On,2014,1999,15,1994,20
I Knew You Were Trouble,2013,1998,15,1989,24
I Love It,2013,1998,15,1995,18
I Luv This Sh*t,2013,1998,15,2011,2
I Want Crazy,2013,1998,15,2013,0
If I Didn't Have You,2013,1998,15,1980,33
Just Give Me A Reason,2013,1998,15,2013,0
Leave The Night On,2014,1999,15,2007,7
Lego House,2013,1998,15,1985,28
Little Bit Of Everything,2013,1998,15,1994,19
Little Talks,2013,1998,15,2012,1
Little Talks,2013,1998,15,2012,1
Little Things,2013,1998,15,2012,1
Little Toy Guns,2015,2000,15,1992,23
Locked Olut Of Heaven,2013,1998,15,1980,33
Lose My Mind,2015,2000,15,1989,26
Love Somebody,2013,1998,15,1980,33
Love You Like A Love Song,2012,1997,15,2011,1
Love You Like That,2015,2000,15,2010,5
Madness,2013,1998,15,2013,0
Maps,2014,1999,15,1980,34
Marry Me,2013,1998,15,1996,17
Midnight Memories,2013,1998,15,1980,33
Mine Would Be You,2013,1998,15,2013,0
Mirrors,2013,1998,15,2013,0
My Songs Know What You Did In The Dark,2013,1998,15,2013,0
Na Na,2014,1999,15,2002,12
Night Train,2013,1998,15,2000,13
One Thing,2012,1997,15,1980,32
Pirate Flag,2013,1998,15,1998,15
Planes,2015,2000,15,2015,0
Play It Again,2014,1999,15,2014,0
Post To Be,2015,2000,15,2015,0
Power Trip,2013,1998,15,2013,0
Ready Or Not,2013,1998,15,2009,4
Right Now,2013,1998,15,2008,5
Roar,2013,1998,15,2013,0
Roller Coaster,2013,1998,15,1980,33
Rotten To The Core,2015,2000,15,2000,15
Round Here,2013,1998,15,1980,33
SOS,2006,1991,15,1980,26
Safe & Sound,2012,1997,15,1980,32
Sail,2013,1998,15,1980,33
See You Again,2013,1998,15,1980,33
She Knows,2015,2000,15,2015,0
She Looks So Perfect,2014,1999,15,2013,1
Something In The Water,2014,1999,15,1980,34
Stay,2013,1998,15,2011,2
Stay,2013,1998,15,2013,0
Steal My Girl,2014,1999,15,1980,34
Still Into You,2013,1998,15,2013,0
Story Of My Life,2013,1998,15,1980,33
Summer,2014,1999,15,1980,34
Summertime Sadness,2013,1998,15,2013,0
Summertime Sadness,2013,1998,15,2013,0
Sure Be Cool If You Did,2013,1998,15,1980,33
Sweater Weather,2013,1998,15,2013,0
Sweater Weather,2013,1998,15,2013,0
Sweeter Than Fiction,2013,1998,15,1980,33
TKO,2013,1998,15,2013,0
Take Back The Night,2013,1998,15,1995,18
The Hanging Tree,2014,1999,15,1980,34
The Only Way I Know,2013,1998,15,1980,33
The Way,2013,1998,15,1980,33
Timber,2014,1999,15,2012,2
Treasure,2013,1998,15,1980,33
Troublemaker,2013,1998,15,2013,0
Truffle Butter,2015,2000,15,2015,0
Trumpets,2014,1999,15,2008,6
Try,2013,1998,15,2005,8
Wagon Wheel,2013,1998,15,2013,0
Walking On Air,2013,1998,15,1992,21
We Can't Stop,2013,1998,15,2011,2
We Were Us,2013,1998,15,2013,0
What Makes You Beautiful,2012,1997,15,2012,0
What Now,2013,1998,15,2013,0
Whatever She's Got,2014,1999,15,2013,1
When I Was Your Man,2013,1998,15,1980,33
Where Have You Been,2012,1997,15,1980,32
Without You,2012,1997,15,2010,2
Worth It,2015,2000,15,1995,20
You're Beautiful,2006,1991,15,1980,26
23,2014,1998,16,1993,21
23,2014,1998,16,1993,21
#SELFIE,2014,1998,16,1988,26
*** Flawless,2014,1998,16,2002,12
0 To 100/The Catch Up,2014,1998,16,2013,1
19 You + Me,2014,1998,16,2000,14
11-Jul,2014,1998,16,2002,12
A Sky Full Of Stars,2014,1998,16,1980,34
About The Money,2014,1998,16,2010,4
Afire Love,2014,1998,16,1983,31
Ain't It Fun,2014,1998,16,1996,18
All About That Bass,2014,1998,16,1980,34
Am I Wrong,2014,1998,16,1980,34
American Kids,2014,1998,16,1995,19
Amnesia,2014,1998,16,1980,34
Anaconda,2014,1998,16,1998,16
Animals,2014,1998,16,2002,12
Automatic,2014,1998,16,1994,20
Ayo,2015,1999,16,2007,8
B**** Better Have My Money,2015,1999,16,2011,4
Baby Don't Lie,2014,1998,16,1980,34
Back To Back,2015,1999,16,2013,2
Bang Bang,2014,1998,16,2011,3
Bartender,2014,1998,16,1980,34
Beachin',2014,1998,16,2008,6
Beat Of The Music,2014,1998,16,1980,34
Beg For It,2015,1999,16,2014,1
Believe Me,2014,1998,16,2011,3
Best Day Of My Life,2014,1998,16,1986,28
Best Mistake,2014,1998,16,2000,14
Birthday,2014,1998,16,2002,12
Black Widow,2014,1998,16,1985,29
Blame,2014,1998,16,1980,34
Blank Space,2014,1998,16,1990,24
Boom Clap,2014,1998,16,2014,0
Booty,2014,1998,16,2014,0
Bottoms Up,2014,1998,16,2014,0
Boyz-N-The-Hood,2015,1999,16,2012,3
Brave,2014,1998,16,2013,1
Break Free,2014,1998,16,1980,34
Burn,2014,1998,16,1980,34
Burnin' It Down,2014,1998,16,2014,0
Can't Remember To Forget You,2014,1998,16,2002,12
Chandelier,2014,1998,16,1980,34
Chillin' It,2014,1998,16,2013,1
Classic,2014,1998,16,2014,0
Come Get It Bae,2014,1998,16,2015,1
Come With Me Now,2014,1998,16,1980,34
Compass,2014,1998,16,2014,0
Counting Stars,2014,1998,16,1988,26
Dark Horse,2014,1998,16,2013,1
Day Drinking,2014,1998,16,1995,19
Don't,2014,1998,16,2008,6
Drink A Beer,2014,1998,16,1980,34
Drink To That All Night,2014,1998,16,1980,34
Drunk On A Plane,2014,1998,16,2014,0
Everything I Didn't Say,2014,1998,16,1980,34
Fancy,2014,1998,16,2014,0
Feel So Close,2012,1996,16,1980,32
Fireball,2014,1998,16,2014,0
Girl Crush,2015,1999,16,2008,7
Give Me Back My Hometown,2014,1998,16,2012,2
Gone Gone Gone,2013,1997,16,2013,0
Good Girls,2014,1998,16,1996,18
Happy,2014,1998,16,1980,34
Headlights,2014,1998,16,2007,7
Hey Brother,2014,1998,16,1987,27
Hold You Down,2014,1998,16,2014,0
Honey I'm Good.,2015,1999,16,2009,6
Hope You Get Lonely Tonight,2014,1998,16,2014,0
Human,2014,1998,16,1980,34
I Don't Dance,2014,1998,16,2014,0
I Don't Mind,2015,1999,16,2014,1
I Need Your Love,2013,1997,16,1980,33
I Need Your Love,2013,1997,16,1980,33
I See You,2015,1999,16,2008,7
I'm Not The Only One,2014,1998,16,2014,0
Invisible,2014,1998,16,1982,32
It Was Always You,2014,1998,16,1980,34
It's Time,2013,1997,16,1993,20
Kiss Me Kiss Me,2014,1998,16,1980,34
Lean On,2015,1999,16,1980,35
Let Her Go,2014,1998,16,1980,34
Lettin' The Night Roll,2014,1998,16,2002,12
Life Of The Party,2014,1998,16,1980,34
Locked Away,2015,1999,16,2015,0
Love Is An Open Door,2014,1998,16,2012,2
Love Me Again,2014,1998,16,1980,34
Love Me Harder,2014,1998,16,2001,13
Love Never Felt So Good,2014,1998,16,1980,34
Love Runs Out,2014,1998,16,2014,0
Magic,2014,1998,16,1980,34
Mary Did You Know?,2014,1998,16,1993,21
Me And My Broken Heart,2014,1998,16,1990,24
Me Love,2007,1991,16,1980,27
Meanwhile Back At Mama's,2014,1998,16,2010,4
My Eyes,2014,1998,16,1998,16
Neon Light,2014,1998,16,1996,18
New Flame,2014,1998,16,2014,0
Night Changes,2014,1998,16,1980,34
Not A Bad Thing,2014,1998,16,1980,34
One Of Those Nights,2013,1997,16,2001,12
Out Of The Woods,2014,1998,16,2003,11
Part Of Me,2012,1996,16,2010,2
Pills N Potions,2014,1998,16,2014,0
Prisoner,2015,1999,16,1980,35
Really Don't Care,2014,1998,16,2014,0
Roller Coaster,2014,1998,16,2006,8
Rude,2014,1998,16,2011,3
Shotgun Rider,2015,1999,16,2014,1
Show Me,2014,1998,16,1993,21
Shower,2014,1998,16,2014,0
Sing,2014,1998,16,2014,0
Slave To The Rhythm,2014,1998,16,2007,7
Somewhere In My Car,2014,1998,16,1980,34
Stay With Me,2014,1998,16,1980,34
Studio,2014,1998,16,2002,12
Style,2015,1999,16,1980,35
Sweet Annie,2013,1997,16,1980,33
Sweet Nothing,2013,1997,16,2003,10
Sweet Nothing,2013,1997,16,2003,10
Talladega,2015,1999,16,1997,18
The Heart Wants What It Wants,2014,1998,16,1987,27
The Man,2014,1998,16,1999,15
The Night Is Still Young,2015,1999,16,2015,0
The Worst,2014,1998,16,2014,0
This Could Be Us,2015,1999,16,2010,5
This Is How We Roll,2014,1998,16,2014,0
This Is How We Roll,2014,1998,16,2014,0
Throw Sum Mo,2015,1999,16,2015,0
Time Of Our Lives,2015,1999,16,2015,0
Tonight Looks Good On You,2015,1999,16,1980,35
Two Black Cadillacs,2013,1997,16,2013,0
Uptown Funk!,2015,1999,16,2014,1
Venus,2013,1997,16,1985,28
Wake Me Up!,2013,1997,16,1980,33
Wasted Love,2015,1999,16,1980,35
Wasting All These Tears,2013,1997,16,2015,2
Waves,2014,1998,16,1980,34
We Might Be Dead By Tomorrow,2014,1998,16,1980,34
What Do You Mean?,2015,1999,16,2010,5
When She Says Baby,2014,1998,16,2014,0
Who I Am With You,2014,1998,16,1980,34
Who You Love,2014,1998,16,1980,34
With Love,2007,1991,16,1980,27
Wrecking Ball,2013,1997,16,2013,0
Yeah,2014,1998,16,2009,5
Yellow Flicker Beat,2014,1998,16,1991,23
You Don't Know Her Like I Do,2012,1996,16,1980,32
Young And Beautiful,2013,1997,16,2013,0
679,2015,1998,17,2015,0
Adore You,2014,1997,17,1980,34
Again,2015,1998,17,2015,0
Ain't Worth The Whiskey,2015,1998,17,1980,35
All Day,2015,1998,17,2011,4
All Eyes On You,2015,1998,17,2003,12
Bad Blood,2015,1998,17,1989,26
Be Real,2015,1998,17,2008,7
Believe,2015,1998,17,1980,35
Billie Jean,2008,1991,17,1980,28
Blessings,2015,1998,17,2013,2
Break Up In A Small Town,2015,1998,17,1987,28
Break Up With Him,2015,1998,17,2012,3
Budapest,2015,1998,17,2015,0
Burning House,2015,1998,17,2013,2
Can't Feel My Face,2015,1998,17,2004,11
Centuries,2015,1998,17,2014,1
Chains,2015,1998,17,2015,0
Cheerleader,2015,1998,17,1988,27
Classic Man,2015,1998,17,2015,0
Confident,2015,1998,17,2013,2
Cool For The Summer,2015,1998,17,2015,0
Crash And Burn,2015,1998,17,1980,35
Dear Future Husband,2015,1998,17,2015,0
Die A Happy Man,2015,1998,17,1980,35
Don't It,2015,1998,17,1980,35
Don't You Worry Child,2013,1996,17,1980,33
Drag Me Down,2015,1998,17,1980,35
Earned It (Fifty Shades Of Grey),2015,1998,17,2006,9
Elastic Heart,2015,1998,17,1980,35
Ex's & Oh's,2015,1998,17,2015,0
Fight Song,2015,1998,17,2015,0
Flex (Ooh Ooh Ooh),2015,1998,17,2015,0
Focus,2015,1998,17,2014,1
FourFiveSeconds,2015,1998,17,2013,2
Fun,2015,1998,17,2004,11
Ghost,2015,1998,17,1980,35
Glory,2015,1998,17,2004,11
Good For You,2015,1998,17,2015,0
Hallelujah,2015,1998,17,1980,35
Heartbeat Song,2015,1998,17,1980,35
Hello,2015,1998,17,1980,35
Heroes (We Could Be),2015,1998,17,2001,14
Homegrown,2015,1998,17,1980,35
Hotline Bling,2015,1998,17,2013,2
House Party,2015,1998,17,2015,0
I Bet,2015,1998,17,2009,6
I Bet My Life,2015,1998,17,1980,35
I Lived,2015,1998,17,1980,35
I Really Like You,2015,1998,17,1980,35
I Want You To Know,2015,1998,17,2015,0
I'm Comin' Over,2015,1998,17,1980,35
Jealous,2015,1998,17,2014,1
La La La,2014,1997,17,2014,0
Lay Me Down,2015,1998,17,2012,3
Levels,2015,1998,17,2015,0
Lonely Eyes,2015,1998,17,2002,13
Lonely Tonight,2015,1998,17,1980,35
Love Me Like You Mean It,2015,1998,17,1980,35
Love Myself,2015,1998,17,1980,35
Loving You Easy,2015,1998,17,1980,35
Make It Rain,2014,1997,17,1980,34
Make Me Wanna,2015,1998,17,2014,1
My Baby's Got A Smile On Her Face,2015,1998,17,2001,14
My Way,2015,1998,17,2015,0
Neon Lights,2014,1997,17,1980,34
On My Mind,2015,1998,17,2015,0
One Hell Of An Amen,2015,1998,17,1980,35
One Last Time,2015,1998,17,2014,1
Only One,2015,1998,17,2015,0
Outside,2015,1998,17,1980,35
Perfect,2015,1998,17,2002,13
Please,2015,1998,17,1980,35
Pompeii,2014,1997,17,2010,4
Pretty Girls,2015,1998,17,2015,0
Royals,2013,1996,17,2013,0
Same Old Love,2015,1998,17,1980,35
Sangria,2015,1998,17,2015,0
Santa Tell Me,2015,1998,17,2015,0
See You Again,2015,1998,17,2001,14
Shut Up And Dance,2015,1998,17,2015,0
Sledgehammer,2015,1998,17,2015,0
Smoke,2015,1998,17,1987,28
Smoke Break,2015,1998,17,2015,0
Somebody,2015,1998,17,2015,0
Sorry,2015,1998,17,2010,5
Stitches,2015,1998,17,1993,22
Stolen Dance,2015,1998,17,2010,5
Straght Outta Compton,2015,1998,17,2002,13
Strip It Down,2015,1998,17,1980,35
Sugar,2015,1998,17,1980,35
Sun Daze,2015,1998,17,2002,13
Take Your Time,2015,1998,17,2015,0
Talking Body,2015,1998,17,1980,35
Tennessee Whiskey,2015,1998,17,1999,16
This Summer's Gonna Hurt...,2015,1998,17,2014,1
Want To Want Me,2015,1998,17,2012,3
Where Are U Now,2015,1998,17,2015,0
You Know You Like It,2015,1998,17,2015,0
Bright,2015,1997,18,2009,6
Conqueror,2015,1997,18,1980,35
Don't Stop The Music,2008,1990,18,1980,28
Let It Go,2014,1996,18,2014,0
Like I'm Gonna Lose You,2015,1997,18,1980,35
Love Me Like You Do,2015,1997,18,2015,0
Oh Sweet Lorraine,2013,1995,18,1995,18
Photograph,2015,1997,18,1995,20
Prayer In C,2015,1997,18,2010,5
She's Kinda Hot,2015,1997,18,1997,18
Thinking Out Loud,2015,1997,18,2008,7
Wildest Dreams,2015,1997,18,2015,0
How Deep Is Your Love,2015,1996,19,2004,11
Midnight,2014,1995,19,1980,34
Sippin' On Fire,2015,1996,19,2009,6
